,row,Txn Date,Description,Transfer To/From,Ref No./Cheque No.,Debit,Credit,Balance,Class,User
0,1,23/12/2022,Baby,True,4670421416617,1124.39,0.0,243044.54,Non-Essential,dakshita
1,2,23/12/2022,Home,True,4142389275287,406.29,0.0,242638.25,Essential,dakshita
2,3,23/12/2022,Home,False,4873015274314,0.0,1041.08,243679.33,Important,dakshita
3,4,23/12/2022,Games,True,4694949599252,2577.05,0.0,241102.28,Non-important,dakshita
4,5,23/12/2022,Health,False,4678644250023,0.0,1628.76,242731.04,Non-important,dakshita
5,6,23/12/2022,Industrial,False,4365009395388,0.0,123.18,242854.22,Essential,dakshita
6,7,23/12/2022,Toys,False,4363456679962,0.0,1438.55,244292.77,Non-important,dakshita
7,8,23/12/2022,Jewelry,True,4637765546020,2814.58,0.0,241478.19,Important,dakshita
8,9,23/12/2022,Tools,True,4109830301820,1181.78,0.0,240296.41,Essential,dakshita
9,10,23/12/2022,Jewelry,True,4809505440023,576.95,0.0,239719.46,Important,dakshita
10,11,23/12/2022,Electronics,False,4293792381835,0.0,788.69,240508.15,Essential,dakshita
11,12,24/12/2022,Games,False,4937437324221,0.0,1420.94,241929.09,Essential,dakshita
12,13,24/12/2022,Garden,False,4457891946069,0.0,2947.88,244876.97,Essential,dakshita
13,14,24/12/2022,Movies,True,4769565638067,32.31,0.0,244844.66,Non-Essential,dakshita
14,15,24/12/2022,Home,True,4355063513530,1776.27,0.0,243068.39,Non-Essential,dakshita
15,16,24/12/2022,Baby,True,4611599897576,1179.91,0.0,241888.48,Non-important,dakshita
16,17,24/12/2022,Games,False,4228003507515,0.0,157.45,242045.93,Non-important,dakshita
17,18,24/12/2022,Kids,False,4212136528515,0.0,1706.31,243752.24,Non-important,dakshita
18,19,24/12/2022,Health,True,4894964738255,1303.02,0.0,242449.22,Important,dakshita
19,20,24/12/2022,Outdoors,True,4256242123894,1363.11,0.0,241086.11,Important,dakshita
20,21,24/12/2022,Health,True,4382269416675,1747.7,0.0,239338.41,Non-important,dakshita
21,22,24/12/2022,Garden,False,4712422304028,0.0,2612.35,241950.76,Essential,dakshita
22,23,24/12/2022,Toys,False,4786925864907,0.0,80.62,242031.38,Essential,dakshita
23,24,24/12/2022,Electronics,False,4902075093563,0.0,993.96,243025.34,Important,dakshita
24,25,24/12/2022,Automotive,True,4249172458985,705.66,0.0,242319.68,Non-important,dakshita
25,26,25/12/2022,Kids,False,4713955915740,0.0,1821.73,244141.41,Essential,dakshita
26,27,25/12/2022,Books,True,4193249354900,387.6,0.0,243753.81,Non-Essential,dakshita
27,28,25/12/2022,Kids,True,4664964198832,1728.91,0.0,242024.9,Non-Essential,dakshita
28,29,25/12/2022,Garden,True,4022660721360,64.96,0.0,241959.94,Essential,dakshita
29,30,25/12/2022,Sports,True,4775617260095,700.39,0.0,241259.55,Non-important,dakshita
30,31,25/12/2022,Books,False,4292020508739,0.0,1498.63,242758.18,Essential,dakshita
31,32,25/12/2022,Shoes,False,4916462860307,0.0,2451.64,245209.82,Important,dakshita
32,33,25/12/2022,Industrial,True,4858779723602,2856.88,0.0,242352.94,Non-important,dakshita
33,34,25/12/2022,Books,True,4984604102702,1824.51,0.0,240528.43,Essential,dakshita
34,35,25/12/2022,Music,True,4732215358475,183.42,0.0,240345.01,Essential,dakshita
35,36,26/12/2022,Grocery,True,4141772694815,2405.64,0.0,237939.37,Essential,dakshita
36,37,26/12/2022,Automotive,False,4602710866398,0.0,1539.38,239478.75,Essential,dakshita
37,38,26/12/2022,Home,True,4656195281424,2483.3,0.0,236995.45,Essential,dakshita
38,39,26/12/2022,Garden,True,4351360247159,2682.03,0.0,234313.42,Essential,dakshita
39,40,26/12/2022,Home,False,4364105001574,0.0,2827.52,237140.94,Non-important,dakshita
40,41,26/12/2022,Toys,True,4837668001879,479.56,0.0,236661.38,Non-important,dakshita
41,42,26/12/2022,Movies,False,4636508643895,0.0,149.28,236810.66,Non-Essential,dakshita
42,43,26/12/2022,Games,False,4951662833181,0.0,995.47,237806.13,Non-Essential,dakshita
43,44,26/12/2022,Jewelry,True,4514323925049,2350.82,0.0,235455.31,Non-important,dakshita
44,45,26/12/2022,Baby,False,4352322088534,0.0,1472.03,236927.34,Important,dakshita
45,46,26/12/2022,Outdoors,False,4723386145003,0.0,1606.81,238534.15,Important,dakshita
46,47,26/12/2022,Grocery,False,4521767140935,0.0,663.16,239197.31,Non-important,dakshita
47,48,26/12/2022,Movies,False,4662109829822,0.0,1074.91,240272.22,Non-Essential,dakshita
48,49,27/12/2022,Music,True,4665368443166,2972.43,0.0,237299.79,Important,dakshita
49,50,27/12/2022,Kids,True,4300704088375,140.86,0.0,237158.93,Essential,dakshita
50,51,27/12/2022,Tools,False,4755802916627,0.0,1518.08,238677.01,Non-important,dakshita
51,52,27/12/2022,Books,True,4340384857806,1443.43,0.0,237233.58,Important,dakshita
52,53,28/12/2022,Kids,False,4428611940966,0.0,28.36,237261.94,Non-important,dakshita
53,54,28/12/2022,Music,False,4187047664006,0.0,712.22,237974.16,Non-important,dakshita
54,55,28/12/2022,Garden,True,4829118652967,568.75,0.0,237405.41,Non-important,dakshita
55,56,28/12/2022,Baby,True,4954847872650,1698.39,0.0,235707.02,Non-Essential,dakshita
56,57,28/12/2022,Games,True,4377153859309,70.99,0.0,235636.03,Non-important,dakshita
57,58,28/12/2022,Shoes,False,4862937354142,0.0,1089.82,236725.85,Non-Essential,dakshita
58,59,28/12/2022,Grocery,False,4761239665266,0.0,2574.75,239300.6,Non-Essential,dakshita
59,60,28/12/2022,Garden,False,4267412922234,0.0,112.79,239413.39,Essential,dakshita
60,61,28/12/2022,Clothing,True,4969553908083,2889.16,0.0,236524.23,Essential,dakshita
61,62,29/12/2022,Toys,True,4976447575723,2663.23,0.0,233861.0,Non-Essential,dakshita
62,63,29/12/2022,Music,False,4778606874487,0.0,1233.42,235094.42,Essential,dakshita
63,64,29/12/2022,Beauty,False,4252974545232,0.0,1091.65,236186.07,Important,dakshita
64,65,29/12/2022,Computers,True,4895236008283,844.93,0.0,235341.14,Non-important,dakshita
65,66,29/12/2022,Toys,False,4138080853552,0.0,2289.32,237630.46,Non-important,dakshita
66,67,29/12/2022,Toys,False,4307960459712,0.0,1662.13,239292.59,Non-Essential,dakshita
67,68,29/12/2022,Sports,False,4659458697865,0.0,1622.84,240915.43,Essential,dakshita
68,69,30/12/2022,Music,False,4839190753491,0.0,943.35,241858.78,Important,dakshita
69,70,30/12/2022,Garden,True,4028846444788,2602.06,0.0,239256.72,Important,dakshita
70,71,30/12/2022,Electronics,False,4378087798569,0.0,2028.92,241285.64,Essential,dakshita
71,72,31/12/2022,Health,True,4566296490429,2689.14,0.0,238596.5,Essential,dakshita
72,73,31/12/2022,Industrial,False,4457498587774,0.0,591.56,239188.06,Non-important,dakshita
73,74,31/12/2022,Garden,True,4815199148265,2303.79,0.0,236884.27,Non-Essential,dakshita
74,75,31/12/2022,Health,True,4063420200877,626.98,0.0,236257.29,Non-important,dakshita
75,76,31/12/2022,Home,True,4367333803036,2183.16,0.0,234074.13,Non-Essential,dakshita
76,77,31/12/2022,Automotive,True,4676944825654,2428.24,0.0,231645.89,Non-important,dakshita
77,78,31/12/2022,Baby,True,4805270600031,245.5,0.0,231400.39,Important,dakshita
78,79,31/12/2022,Sports,False,4217913045440,0.0,2483.47,233883.86,Non-Essential,dakshita
79,80,31/12/2022,Kids,True,4272875290929,1399.46,0.0,232484.4,Essential,dakshita
80,81,31/12/2022,Computers,False,4801233701579,0.0,1842.9,234327.3,Non-important,dakshita
81,82,31/12/2022,Music,True,4252058197827,1069.88,0.0,233257.42,Non-Essential,dakshita
82,83,31/12/2022,Baby,True,4064883698128,2991.25,0.0,230266.17,Important,dakshita
83,84,31/12/2022,Health,False,4505202809794,0.0,1337.78,231603.95,Essential,dakshita
84,85,31/12/2022,Clothing,False,4771099713687,0.0,2823.25,234427.2,Essential,dakshita
85,86,01/01/2023,Computers,True,4451367772428,838.77,0.0,233588.43,Non-Essential,dakshita
86,87,01/01/2023,Books,False,4609086859438,0.0,1525.79,235114.22,Non-Essential,dakshita
87,88,01/01/2023,Grocery,True,4676069635728,812.12,0.0,234302.1,Important,dakshita
88,89,01/01/2023,Outdoors,False,4343609341078,0.0,479.33,234781.43,Non-important,dakshita
89,90,01/01/2023,Baby,True,4237815886528,1997.54,0.0,232783.89,Essential,dakshita
90,91,01/01/2023,Health,True,4295233556019,1776.51,0.0,231007.38,Non-important,dakshita
91,92,01/01/2023,Movies,True,4773320302238,1099.0,0.0,229908.38,Essential,dakshita
92,93,02/01/2023,Computers,True,4473028825523,2985.08,0.0,226923.3,Essential,dakshita
93,94,02/01/2023,Home,True,4503140667720,798.34,0.0,226124.96,Non-Essential,dakshita
94,95,02/01/2023,Books,False,4728009337867,0.0,2024.72,228149.68,Non-important,dakshita
95,96,02/01/2023,Shoes,True,4022773478841,9.0,0.0,228140.68,Important,dakshita
96,97,02/01/2023,Tools,False,4740116662809,0.0,1274.49,229415.17,Important,dakshita
97,98,02/01/2023,Industrial,False,4665764817822,0.0,1136.49,230551.66,Non-important,dakshita
98,99,02/01/2023,Movies,True,4072695375156,726.12,0.0,229825.54,Non-important,dakshita
99,100,02/01/2023,Industrial,False,4576412886389,0.0,502.58,230328.12,Non-Essential,dakshita
100,101,02/01/2023,Garden,False,4828745854310,0.0,2159.83,232487.95,Important,dakshita
101,102,02/01/2023,Shoes,False,4951838583917,0.0,631.58,233119.53,Non-important,dakshita
102,103,02/01/2023,Grocery,False,4128521788034,0.0,1608.1,234727.63,Important,dakshita
103,104,02/01/2023,Home,True,4292540434916,1121.09,0.0,233606.54,Non-Essential,dakshita
104,105,02/01/2023,Garden,False,4304288399287,0.0,973.09,234579.63,Essential,dakshita
105,106,03/01/2023,Music,True,4947010714421,2159.24,0.0,232420.39,Non-important,dakshita
106,107,03/01/2023,Outdoors,False,4077330755846,0.0,588.24,233008.63,Important,dakshita
107,108,03/01/2023,Grocery,False,4317314059648,0.0,2509.39,235518.02,Non-important,dakshita
108,109,03/01/2023,Home,True,4566691368898,2306.8,0.0,233211.22,Essential,dakshita
109,110,03/01/2023,Movies,False,4507244283994,0.0,1367.95,234579.17,Non-Essential,dakshita
110,111,03/01/2023,Garden,True,4468672870505,1111.71,0.0,233467.46,Non-Essential,dakshita
111,112,03/01/2023,Toys,True,4798022299050,1330.55,0.0,232136.91,Non-Essential,dakshita
112,113,03/01/2023,Games,False,4996503234946,0.0,2416.93,234553.84,Important,dakshita
113,114,03/01/2023,Shoes,False,4483019376460,0.0,2608.3,237162.14,Non-Essential,dakshita
114,115,03/01/2023,Tools,True,4899838202783,545.52,0.0,236616.62,Essential,dakshita
115,116,04/01/2023,Games,False,4455118002219,0.0,2462.62,239079.24,Non-important,dakshita
116,117,04/01/2023,Games,False,4980907547380,0.0,479.05,239558.29,Essential,dakshita
117,118,04/01/2023,Books,True,4085179813001,2910.87,0.0,236647.42,Essential,dakshita
118,119,04/01/2023,Industrial,False,4032927668314,0.0,916.26,237563.68,Non-important,dakshita
119,120,04/01/2023,Grocery,True,4471224719254,2739.93,0.0,234823.75,Essential,dakshita
120,121,04/01/2023,Games,True,4366305464776,2669.86,0.0,232153.89,Non-important,dakshita
121,122,04/01/2023,Sports,True,4036561056336,2411.39,0.0,229742.5,Non-important,dakshita
122,123,04/01/2023,Movies,True,4554719118496,268.8,0.0,229473.7,Non-Essential,dakshita
123,124,05/01/2023,Outdoors,True,4533779487214,47.35,0.0,229426.35,Non-Essential,dakshita
124,125,05/01/2023,Baby,True,4540850720948,1296.97,0.0,228129.38,Essential,dakshita
125,126,05/01/2023,Tools,False,4751064105174,0.0,277.24,228406.62,Essential,dakshita
126,127,05/01/2023,Clothing,False,4457314477739,0.0,2016.0,230422.62,Essential,dakshita
127,128,05/01/2023,Tools,False,4254051097193,0.0,1862.79,232285.41,Non-important,dakshita
128,129,05/01/2023,Sports,True,4999249563132,2502.15,0.0,229783.26,Non-important,dakshita
129,130,05/01/2023,Baby,False,4329067614801,0.0,1280.37,231063.63,Non-Essential,dakshita
130,131,05/01/2023,Automotive,True,4872755986691,1419.65,0.0,229643.98,Non-important,dakshita
131,132,06/01/2023,Shoes,True,4139622499458,961.85,0.0,228682.13,Non-important,dakshita
132,133,06/01/2023,Toys,False,4317887639488,0.0,120.34,228802.47,Non-Essential,dakshita
133,134,06/01/2023,Outdoors,True,4961636508039,2258.24,0.0,226544.23,Important,dakshita
134,135,06/01/2023,Music,False,4030393031441,0.0,410.42,226954.65,Essential,dakshita
135,136,06/01/2023,Grocery,True,4311248281923,1183.15,0.0,225771.5,Non-important,dakshita
136,137,06/01/2023,Outdoors,False,4420477851533,0.0,1585.47,227356.97,Essential,dakshita
137,138,06/01/2023,Home,True,4312511882802,971.28,0.0,226385.69,Non-Essential,dakshita
138,139,06/01/2023,Health,True,4943477257673,975.74,0.0,225409.95,Non-important,dakshita
139,140,06/01/2023,Beauty,False,4550239343061,0.0,452.86,225862.81,Non-Essential,dakshita
140,141,07/01/2023,Baby,False,4372688760186,0.0,1276.83,227139.64,Essential,dakshita
141,142,07/01/2023,Games,True,4350123038536,414.68,0.0,226724.96,Non-important,dakshita
142,143,07/01/2023,Electronics,False,4647191230638,0.0,1815.21,228540.17,Essential,dakshita
143,144,07/01/2023,Automotive,False,4310979651970,0.0,888.4,229428.57,Non-Essential,dakshita
144,145,07/01/2023,Clothing,True,4662149078038,2323.66,0.0,227104.91,Non-important,dakshita
145,146,07/01/2023,Movies,False,4246457399813,0.0,2415.65,229520.56,Non-Essential,dakshita
146,147,07/01/2023,Games,False,4670151608113,0.0,701.88,230222.44,Essential,dakshita
147,148,07/01/2023,Books,True,4051306291879,561.02,0.0,229661.42,Essential,dakshita
148,149,07/01/2023,Sports,True,4130156391660,2423.84,0.0,227237.58,Non-Essential,dakshita
149,150,08/01/2023,Jewelry,True,4016005202113,1983.46,0.0,225254.12,Essential,dakshita
150,151,08/01/2023,Garden,True,4563037604395,2797.57,0.0,222456.55,Essential,dakshita
151,152,08/01/2023,Beauty,False,4350586723105,0.0,2218.98,224675.53,Important,dakshita
152,153,08/01/2023,Computers,True,4214671116136,2768.01,0.0,221907.52,Essential,dakshita
153,154,08/01/2023,Shoes,True,4900075381977,296.9,0.0,221610.62,Non-Essential,dakshita
154,155,08/01/2023,Sports,True,4099671558303,91.16,0.0,221519.46,Non-important,dakshita
155,156,08/01/2023,Clothing,True,4625985786417,823.22,0.0,220696.24,Non-Essential,dakshita
156,157,08/01/2023,Grocery,False,4230187372209,0.0,2489.07,223185.31,Non-Essential,dakshita
157,158,09/01/2023,Movies,True,4906313998383,1738.97,0.0,221446.34,Non-Essential,dakshita
158,159,09/01/2023,Home,False,4991122682733,0.0,1223.5,222669.84,Non-Essential,dakshita
159,160,09/01/2023,Tools,True,4374364699872,456.46,0.0,222213.38,Non-Essential,dakshita
160,161,09/01/2023,Home,False,4494488870231,0.0,566.11,222779.49,Non-important,dakshita
161,162,09/01/2023,Sports,True,4150748307409,2508.75,0.0,220270.74,Essential,dakshita
162,163,09/01/2023,Shoes,False,4888691798894,0.0,2129.35,222400.09,Non-Essential,dakshita
163,164,09/01/2023,Toys,False,4020721954398,0.0,2933.2,225333.29,Important,dakshita
164,165,09/01/2023,Clothing,False,4621611956755,0.0,2482.88,227816.17,Non-important,dakshita
165,166,09/01/2023,Industrial,False,4275267900503,0.0,1486.18,229302.35,Essential,dakshita
166,167,10/01/2023,Sports,True,4833811432255,1271.51,0.0,228030.84,Essential,dakshita
167,168,10/01/2023,Tools,True,4876880032343,269.01,0.0,227761.83,Important,dakshita
168,169,10/01/2023,Jewelry,True,4865677371038,517.62,0.0,227244.21,Important,dakshita
169,170,10/01/2023,Sports,False,4273764486823,0.0,2132.45,229376.66,Non-Essential,dakshita
170,171,10/01/2023,Baby,False,4442448349125,0.0,2567.14,231943.8,Non-Essential,dakshita
171,172,10/01/2023,Beauty,True,4822135668918,1208.29,0.0,230735.51,Essential,dakshita
172,173,10/01/2023,Computers,False,4894644110024,0.0,816.26,231551.77,Non-important,dakshita
173,174,10/01/2023,Movies,True,4571562005663,2441.12,0.0,229110.65,Important,dakshita
174,175,10/01/2023,Beauty,False,4611787956987,0.0,388.47,229499.12,Essential,dakshita
175,176,10/01/2023,Movies,False,4323322077855,0.0,777.45,230276.57,Essential,dakshita
176,177,11/01/2023,Movies,False,4453817222277,0.0,2250.15,232526.72,Non-Essential,dakshita
177,178,11/01/2023,Automotive,False,4276468841042,0.0,2752.08,235278.8,Essential,dakshita
178,179,11/01/2023,Kids,True,4194936596207,1271.69,0.0,234007.11,Important,dakshita
179,180,11/01/2023,Tools,False,4150592956851,0.0,131.05,234138.16,Non-Essential,dakshita
180,181,11/01/2023,Games,False,4054884313853,0.0,875.14,235013.3,Important,dakshita
181,182,11/01/2023,Sports,False,4197053777978,0.0,2344.97,237358.27,Non-Essential,dakshita
182,183,11/01/2023,Industrial,False,4390117391641,0.0,141.8,237500.07,Essential,dakshita
183,184,11/01/2023,Outdoors,False,4683882057279,0.0,1837.39,239337.46,Non-Essential,dakshita
184,185,11/01/2023,Health,True,4051658986523,1991.7,0.0,237345.76,Essential,dakshita
185,186,12/01/2023,Electronics,True,4233140696196,2633.27,0.0,234712.49,Important,dakshita
186,187,12/01/2023,Sports,True,4307040411081,680.76,0.0,234031.73,Essential,dakshita
187,188,12/01/2023,Games,False,4166266547978,0.0,490.44,234522.17,Non-Essential,dakshita
188,189,12/01/2023,Outdoors,False,4146652110330,0.0,826.05,235348.22,Non-important,dakshita
189,190,12/01/2023,Garden,True,4509229701675,2254.49,0.0,233093.73,Non-Essential,dakshita
190,191,12/01/2023,Health,False,4859804231267,0.0,1839.3,234933.03,Essential,dakshita
191,192,12/01/2023,Toys,False,4561983386029,0.0,1776.72,236709.75,Non-Essential,dakshita
192,193,12/01/2023,Kids,False,4905601563884,0.0,1901.5,238611.25,Important,dakshita
193,194,12/01/2023,Computers,False,4570200011680,0.0,1300.37,239911.62,Non-important,dakshita
194,195,12/01/2023,Automotive,False,4461192280704,0.0,2675.3,242586.92,Non-important,dakshita
195,196,12/01/2023,Grocery,False,4428990206590,0.0,76.28,242663.2,Non-Essential,dakshita
196,197,13/01/2023,Books,False,4624118745515,0.0,2067.76,244730.96,Non-important,dakshita
197,198,13/01/2023,Health,True,4185445790002,510.51,0.0,244220.45,Important,dakshita
198,199,13/01/2023,Industrial,True,4690808555631,2903.75,0.0,241316.7,Essential,dakshita
199,200,13/01/2023,Automotive,False,4360214599976,0.0,2872.0,244188.7,Non-Essential,dakshita
200,201,13/01/2023,Industrial,True,4514057676093,381.05,0.0,243807.65,Non-Essential,dakshita
201,202,13/01/2023,Beauty,False,4893153869732,0.0,2679.5,246487.15,Important,dakshita
202,203,13/01/2023,Kids,False,4597938196987,0.0,2093.95,248581.1,Non-important,dakshita
203,204,13/01/2023,Tools,True,4420783978948,1815.42,0.0,246765.68,Essential,dakshita
204,205,13/01/2023,Tools,False,4617470736078,0.0,2395.87,249161.55,Non-Essential,dakshita
205,206,13/01/2023,Industrial,False,4590898090541,0.0,1218.03,250379.58,Non-important,dakshita
206,207,13/01/2023,Industrial,False,4312133934124,0.0,781.74,251161.32,Non-important,dakshita
207,208,13/01/2023,Tools,True,4200089060214,388.39,0.0,250772.93,Non-important,dakshita
208,209,13/01/2023,Jewelry,True,4146863202185,553.07,0.0,250219.86,Non-important,dakshita
209,210,13/01/2023,Automotive,False,4411947261803,0.0,654.47,250874.33,Important,dakshita
210,211,14/01/2023,Beauty,False,4511828250489,0.0,2176.45,253050.78,Non-Essential,dakshita
211,212,14/01/2023,Movies,False,4087631732112,0.0,2204.11,255254.89,Non-Essential,dakshita
212,213,14/01/2023,Computers,True,4515001095899,482.66,0.0,254772.23,Non-Essential,dakshita
213,214,14/01/2023,Tools,False,4840217043257,0.0,2493.59,257265.82,Non-important,dakshita
214,215,14/01/2023,Garden,True,4069912607222,872.67,0.0,256393.15,Essential,dakshita
215,216,14/01/2023,Jewelry,True,4767914465555,2225.67,0.0,254167.48,Non-Essential,dakshita
216,217,14/01/2023,Clothing,True,4888478224916,1813.5,0.0,252353.98,Essential,dakshita
217,218,14/01/2023,Beauty,True,4076371862683,2134.21,0.0,250219.77,Essential,dakshita
218,219,14/01/2023,Games,True,4419250986471,1000.95,0.0,249218.82,Essential,dakshita
219,220,14/01/2023,Books,True,4669642123239,2039.28,0.0,247179.54,Essential,dakshita
220,221,14/01/2023,Garden,True,4654171602643,2925.88,0.0,244253.66,Non-important,dakshita
221,222,14/01/2023,Outdoors,True,4640111654323,891.37,0.0,243362.29,Non-important,dakshita
222,223,14/01/2023,Kids,True,4213106691939,1942.23,0.0,241420.06,Essential,dakshita
223,224,14/01/2023,Grocery,False,4993134333627,0.0,1448.07,242868.13,Non-important,dakshita
224,225,15/01/2023,Music,False,4486334903701,0.0,2897.97,245766.1,Essential,dakshita
225,226,15/01/2023,Electronics,False,4062851153037,0.0,1826.6,247592.7,Non-important,dakshita
226,227,15/01/2023,Sports,True,4074239919400,87.67,0.0,247505.03,Important,dakshita
227,228,15/01/2023,Automotive,False,4900883947820,0.0,1163.35,248668.38,Essential,dakshita
228,229,15/01/2023,Garden,False,4674871307883,0.0,2845.74,251514.12,Non-Essential,dakshita
229,230,15/01/2023,Health,True,4400847972302,561.81,0.0,250952.31,Non-important,dakshita
230,231,15/01/2023,Jewelry,False,4479746609020,0.0,2864.7,253817.01,Important,dakshita
231,232,15/01/2023,Automotive,False,4273943233041,0.0,39.12,253856.13,Important,dakshita
232,233,15/01/2023,Health,False,4934957318330,0.0,1338.46,255194.59,Non-important,dakshita
233,234,15/01/2023,Automotive,True,4518360442163,1638.64,0.0,253555.95,Important,dakshita
234,235,15/01/2023,Sports,False,4250569010537,0.0,1533.94,255089.89,Non-important,dakshita
235,236,16/01/2023,Home,False,4262247479620,0.0,811.54,255901.43,Essential,dakshita
236,237,16/01/2023,Jewelry,False,4556138709729,0.0,201.9,256103.33,Important,dakshita
237,238,16/01/2023,Tools,True,4100668744793,744.54,0.0,255358.79,Important,dakshita
238,239,16/01/2023,Tools,False,4872461185804,0.0,2208.13,257566.92,Non-Essential,dakshita
239,240,16/01/2023,Books,False,4352189518658,0.0,1245.37,258812.29,Non-Essential,dakshita
240,241,16/01/2023,Books,True,4962514683376,1362.78,0.0,257449.51,Non-Essential,dakshita
241,242,16/01/2023,Computers,False,4654206177572,0.0,2643.26,260092.77,Essential,dakshita
242,243,16/01/2023,Kids,False,4762272735769,0.0,169.05,260261.82,Non-Essential,dakshita
243,244,16/01/2023,Grocery,True,4515806173350,1236.54,0.0,259025.28,Essential,dakshita
244,245,16/01/2023,Sports,False,4137998533562,0.0,2091.58,261116.86,Essential,dakshita
245,246,16/01/2023,Garden,True,4306015089272,2494.14,0.0,258622.72,Essential,dakshita
246,247,16/01/2023,Outdoors,False,4792231599793,0.0,1329.07,259951.79,Important,dakshita
247,248,16/01/2023,Games,True,4113459544892,2258.67,0.0,257693.12,Important,dakshita
248,249,16/01/2023,Automotive,False,4758397183702,0.0,1528.28,259221.4,Non-important,dakshita
249,250,16/01/2023,Health,False,4741479987272,0.0,1408.57,260629.97,Important,dakshita
250,251,16/01/2023,Music,True,4483368063626,430.04,0.0,260199.93,Important,dakshita
251,252,16/01/2023,Games,True,4544361570612,1451.35,0.0,258748.58,Essential,dakshita
252,253,16/01/2023,Beauty,False,4471771126779,0.0,2278.23,261026.81,Non-important,dakshita
253,254,16/01/2023,Baby,False,4229168300370,0.0,2268.01,263294.82,Non-Essential,dakshita
254,255,17/01/2023,Tools,True,4923819657295,97.4,0.0,263197.42,Important,dakshita
255,256,17/01/2023,Jewelry,True,4416905488179,85.75,0.0,263111.67,Essential,dakshita
256,257,17/01/2023,Garden,False,4195141604302,0.0,236.07,263347.74,Important,dakshita
257,258,17/01/2023,Toys,True,4771731930189,1708.92,0.0,261638.82,Important,dakshita
258,259,17/01/2023,Grocery,False,4722498818864,0.0,2025.23,263664.05,Non-important,dakshita
259,260,17/01/2023,Outdoors,True,4736532226510,209.44,0.0,263454.61,Non-Essential,dakshita
260,261,17/01/2023,Automotive,True,4746159155517,297.34,0.0,263157.27,Non-important,dakshita
261,262,17/01/2023,Home,False,4713798483140,0.0,2634.59,265791.86,Essential,dakshita
262,263,17/01/2023,Shoes,False,4036103904957,0.0,1994.67,267786.53,Non-Essential,dakshita
263,264,17/01/2023,Toys,True,4539548630438,1867.34,0.0,265919.19,Important,dakshita
264,265,17/01/2023,Industrial,False,4629408733774,0.0,1667.0,267586.19,Non-important,dakshita
265,266,18/01/2023,Shoes,True,4186526276220,2036.26,0.0,265549.93,Non-important,dakshita
266,267,18/01/2023,Industrial,True,4623269656906,138.54,0.0,265411.39,Essential,dakshita
267,268,18/01/2023,Jewelry,False,4717722542602,0.0,333.37,265744.76,Non-Essential,dakshita
268,269,18/01/2023,Shoes,False,4010365528057,0.0,1562.08,267306.84,Essential,dakshita
269,270,18/01/2023,Grocery,False,4569767042467,0.0,533.78,267840.62,Non-important,dakshita
270,271,18/01/2023,Outdoors,True,4983727244550,19.38,0.0,267821.24,Essential,dakshita
271,272,18/01/2023,Baby,True,4383404560037,2406.52,0.0,265414.72,Non-important,dakshita
272,273,18/01/2023,Outdoors,True,4924282668783,342.87,0.0,265071.85,Important,dakshita
273,274,18/01/2023,Jewelry,False,4447132225999,0.0,703.16,265775.01,Non-important,dakshita
274,275,18/01/2023,Shoes,False,4202207600624,0.0,1465.26,267240.27,Non-Essential,dakshita
275,276,18/01/2023,Home,False,4163411267749,0.0,2428.58,269668.85,Essential,dakshita
276,277,18/01/2023,Toys,False,4414858904600,0.0,1124.37,270793.22,Non-Essential,dakshita
277,278,18/01/2023,Jewelry,True,4965210354470,2455.51,0.0,268337.71,Non-important,dakshita
278,279,19/01/2023,Movies,True,4207139762637,2106.14,0.0,266231.57,Important,dakshita
279,280,19/01/2023,Games,True,4772320899450,972.52,0.0,265259.05,Non-Essential,dakshita
280,281,19/01/2023,Health,False,4012298818599,0.0,2820.46,268079.51,Non-important,dakshita
281,282,19/01/2023,Outdoors,False,4863974487055,0.0,1793.88,269873.39,Non-important,dakshita
282,283,19/01/2023,Automotive,False,4753339040648,0.0,427.94,270301.33,Important,dakshita
283,284,19/01/2023,Books,True,4010651489740,1472.17,0.0,268829.16,Essential,dakshita
284,285,19/01/2023,Grocery,False,4049577022812,0.0,2416.17,271245.33,Non-important,dakshita
285,286,19/01/2023,Beauty,False,4563831600858,0.0,1050.95,272296.28,Non-important,dakshita
286,287,19/01/2023,Toys,True,4280587048927,2113.31,0.0,270182.97,Non-Essential,dakshita
287,288,19/01/2023,Jewelry,False,4896752935386,0.0,2754.6,272937.57,Non-important,dakshita
288,289,19/01/2023,Clothing,False,4607048686732,0.0,2616.19,275553.76,Non-important,dakshita
289,290,19/01/2023,Music,False,4125916457187,0.0,2306.17,277859.93,Non-important,dakshita
290,291,20/01/2023,Books,False,4006276426832,0.0,546.89,278406.82,Essential,dakshita
291,292,20/01/2023,Toys,False,4844933640879,0.0,1619.33,280026.15,Non-Essential,dakshita
292,293,20/01/2023,Computers,False,4327641839817,0.0,2388.79,282414.94,Non-important,dakshita
293,294,20/01/2023,Computers,True,4604802174917,1491.11,0.0,280923.83,Essential,dakshita
294,295,20/01/2023,Tools,False,4707060706643,0.0,1921.56,282845.39,Non-Essential,dakshita
295,296,20/01/2023,Shoes,True,4533376582626,2497.02,0.0,280348.37,Important,dakshita
296,297,20/01/2023,Clothing,False,4496308247927,0.0,2293.68,282642.05,Non-important,dakshita
297,298,20/01/2023,Outdoors,True,4329996860857,921.33,0.0,281720.72,Important,dakshita
298,299,20/01/2023,Electronics,True,4998290225286,2074.7,0.0,279646.02,Non-important,dakshita
299,300,20/01/2023,Tools,False,4380501600267,0.0,1626.39,281272.41,Non-important,dakshita
300,301,20/01/2023,Tools,True,4733567136561,154.43,0.0,281117.98,Non-Essential,dakshita
301,302,21/01/2023,Movies,False,4154900408044,0.0,2947.31,284065.29,Important,dakshita
302,303,21/01/2023,Tools,False,4463877066361,0.0,1747.44,285812.73,Non-Essential,dakshita
303,304,21/01/2023,Movies,True,4851582623620,1746.32,0.0,284066.41,Non-Essential,dakshita
304,305,21/01/2023,Tools,False,4886143449571,0.0,2720.91,286787.32,Non-important,dakshita
305,306,21/01/2023,Tools,False,4241393481543,0.0,1651.25,288438.57,Non-Essential,dakshita
306,307,21/01/2023,Grocery,True,4274323017160,2303.62,0.0,286134.95,Important,dakshita
307,308,21/01/2023,Home,False,4330049544005,0.0,2898.46,289033.41,Essential,dakshita
308,309,21/01/2023,Games,True,4201555370695,194.29,0.0,288839.12,Non-important,dakshita
309,310,21/01/2023,Tools,True,4005354782041,1994.66,0.0,286844.46,Important,dakshita
310,311,22/01/2023,Toys,True,4790801087783,2095.0,0.0,284749.46,Important,dakshita
311,312,22/01/2023,Sports,False,4403773279177,0.0,196.8,284946.26,Non-Essential,dakshita
312,313,22/01/2023,Games,True,4488051990263,2704.81,0.0,282241.45,Important,dakshita
313,314,22/01/2023,Kids,False,4446391966970,0.0,139.17,282380.62,Essential,dakshita
314,315,22/01/2023,Electronics,False,4671171290321,0.0,219.24,282599.86,Non-important,dakshita
315,316,22/01/2023,Books,True,4742654785368,824.39,0.0,281775.47,Important,dakshita
316,317,22/01/2023,Electronics,True,4500728439001,2332.63,0.0,279442.84,Non-important,dakshita
317,318,23/01/2023,Books,False,4798649613787,0.0,805.46,280248.3,Non-important,dakshita
318,319,23/01/2023,Beauty,False,4706973389977,0.0,660.68,280908.98,Essential,dakshita
319,320,23/01/2023,Grocery,False,4115971913297,0.0,2871.68,283780.66,Important,dakshita
320,321,23/01/2023,Computers,False,4691584278886,0.0,2480.76,286261.42,Non-Essential,dakshita
321,322,23/01/2023,Books,False,4334416687473,0.0,1843.21,288104.63,Essential,dakshita
322,323,23/01/2023,Outdoors,True,4777643552528,646.62,0.0,287458.01,Important,dakshita
323,324,23/01/2023,Computers,False,4311481980262,0.0,2978.08,290436.09,Non-important,dakshita
324,325,23/01/2023,Outdoors,False,4334906003776,0.0,1875.69,292311.78,Non-Essential,dakshita
325,326,23/01/2023,Music,False,4036230558721,0.0,153.92,292465.7,Essential,dakshita
326,327,23/01/2023,Health,True,4116849952369,2958.73,0.0,289506.97,Important,dakshita
327,328,23/01/2023,Toys,True,4617426314071,2880.25,0.0,286626.72,Important,dakshita
328,329,23/01/2023,Tools,False,4644910720879,0.0,2923.59,289550.31,Non-Essential,dakshita
329,330,23/01/2023,Automotive,False,4207913577546,0.0,329.69,289880.0,Non-important,dakshita
330,331,23/01/2023,Electronics,True,4089597760347,1436.35,0.0,288443.65,Essential,dakshita
331,332,23/01/2023,Sports,True,4610539637423,2799.39,0.0,285644.26,Non-important,dakshita
332,333,23/01/2023,Outdoors,False,4953124810627,0.0,1604.52,287248.78,Important,dakshita
333,334,23/01/2023,Home,True,4149581570351,148.3,0.0,287100.48,Non-Essential,dakshita
334,335,23/01/2023,Books,False,4233912699846,0.0,1896.44,288996.92,Essential,dakshita
335,336,23/01/2023,Industrial,False,4177907933902,0.0,1392.24,290389.16,Important,dakshita
336,337,23/01/2023,Games,True,4657543302546,275.19,0.0,290113.97,Non-Essential,dakshita
337,338,24/01/2023,Home,True,4536119625923,56.56,0.0,290057.41,Non-Essential,dakshita
338,339,24/01/2023,Games,True,4394480005436,2039.2,0.0,288018.21,Non-important,dakshita
339,340,24/01/2023,Outdoors,False,4008544511281,0.0,990.2,289008.41,Non-Essential,dakshita
340,341,24/01/2023,Home,True,4456576084467,1710.18,0.0,287298.23,Important,dakshita
341,342,24/01/2023,Baby,True,4630907826422,2312.02,0.0,284986.21,Essential,dakshita
342,343,24/01/2023,Beauty,True,4128710135975,1757.38,0.0,283228.83,Non-Essential,dakshita
343,344,24/01/2023,Garden,False,4853130976802,0.0,225.13,283453.96,Non-Essential,dakshita
344,345,24/01/2023,Beauty,True,4859432777222,2328.88,0.0,281125.08,Essential,dakshita
345,346,24/01/2023,Games,False,4320809794297,0.0,2634.31,283759.39,Non-Essential,dakshita
346,347,24/01/2023,Health,False,4068385700525,0.0,2751.26,286510.65,Non-important,dakshita
347,348,24/01/2023,Tools,False,4910482459287,0.0,1803.95,288314.6,Non-important,dakshita
348,349,24/01/2023,Grocery,False,4652486387718,0.0,2853.88,291168.48,Essential,dakshita
349,350,24/01/2023,Industrial,False,4339311390960,0.0,1566.74,292735.22,Essential,dakshita
350,351,25/01/2023,Kids,True,4803774375134,891.82,0.0,291843.4,Important,dakshita
351,352,25/01/2023,Games,True,4180056783191,1038.93,0.0,290804.47,Non-important,dakshita
352,353,25/01/2023,Garden,False,4385993708935,0.0,1025.81,291830.28,Non-important,dakshita
353,354,25/01/2023,Electronics,False,4304057637200,0.0,1012.04,292842.32,Non-important,dakshita
354,355,25/01/2023,Kids,False,4478113079309,0.0,2848.4,295690.72,Non-important,dakshita
355,356,25/01/2023,Music,False,4086353729074,0.0,2105.11,297795.83,Non-important,dakshita
356,357,25/01/2023,Computers,False,4365953430486,0.0,1450.66,299246.49,Essential,dakshita
357,358,25/01/2023,Music,False,4373441812720,0.0,609.67,299856.16,Essential,dakshita
358,359,25/01/2023,Garden,True,4575032459428,2923.41,0.0,296932.75,Essential,dakshita
359,360,25/01/2023,Shoes,True,4868260842802,2303.76,0.0,294628.99,Non-important,dakshita
360,361,25/01/2023,Beauty,True,4184960839039,1286.8,0.0,293342.19,Important,dakshita
361,362,25/01/2023,Baby,True,4159398476471,580.6,0.0,292761.59,Non-Essential,dakshita
362,363,26/01/2023,Baby,False,4088175465052,0.0,925.72,293687.31,Essential,dakshita
363,364,26/01/2023,Grocery,True,4476819054487,1197.43,0.0,292489.88,Non-Essential,dakshita
364,365,26/01/2023,Games,False,4142173131165,0.0,2186.42,294676.3,Non-important,dakshita
365,366,26/01/2023,Tools,True,4221486047334,2768.67,0.0,291907.63,Essential,dakshita
366,367,26/01/2023,Grocery,True,4571189718858,851.62,0.0,291056.01,Essential,dakshita
367,368,26/01/2023,Automotive,True,4256657981371,230.34,0.0,290825.67,Non-important,dakshita
368,369,26/01/2023,Electronics,False,4210328380777,0.0,534.81,291360.48,Non-Essential,dakshita
369,370,26/01/2023,Electronics,False,4828689213628,0.0,845.4,292205.88,Non-important,dakshita
370,371,26/01/2023,Grocery,True,4148722856089,1425.59,0.0,290780.29,Non-Essential,dakshita
371,372,26/01/2023,Industrial,True,4336267408406,132.35,0.0,290647.94,Important,dakshita
372,373,27/01/2023,Home,False,4891931509338,0.0,382.79,291030.73,Important,dakshita
373,374,27/01/2023,Games,False,4966470347785,0.0,2218.39,293249.12,Non-Essential,dakshita
374,375,27/01/2023,Books,False,4410529370157,0.0,162.69,293411.81,Non-Essential,dakshita
375,376,27/01/2023,Books,True,4338736397016,19.64,0.0,293392.17,Non-Essential,dakshita
376,377,27/01/2023,Tools,False,4268473533027,0.0,2305.49,295697.66,Essential,dakshita
377,378,27/01/2023,Games,False,4387873986055,0.0,1171.49,296869.15,Important,dakshita
378,379,27/01/2023,Grocery,True,4825576086236,1461.52,0.0,295407.63,Essential,dakshita
379,380,27/01/2023,Music,False,4898354424862,0.0,1822.94,297230.57,Essential,dakshita
380,381,27/01/2023,Tools,False,4862619055926,0.0,365.93,297596.5,Non-Essential,dakshita
381,382,27/01/2023,Kids,True,4418246868006,955.24,0.0,296641.26,Non-Essential,dakshita
382,383,27/01/2023,Grocery,True,4997549565043,732.48,0.0,295908.78,Essential,dakshita
383,384,28/01/2023,Music,False,4445834211723,0.0,718.51,296627.29,Non-Essential,dakshita
384,385,28/01/2023,Home,True,4312487557306,1794.65,0.0,294832.64,Non-important,dakshita
385,386,28/01/2023,Outdoors,False,4857047559721,0.0,1958.65,296791.29,Non-important,dakshita
386,387,28/01/2023,Automotive,False,4754582359706,0.0,2223.56,299014.85,Essential,dakshita
387,388,28/01/2023,Shoes,True,4250024993450,1455.99,0.0,297558.86,Non-Essential,dakshita
388,389,28/01/2023,Outdoors,True,4771965960545,252.85,0.0,297306.01,Non-important,dakshita
389,390,28/01/2023,Toys,False,4011966430458,0.0,98.87,297404.88,Non-Essential,dakshita
390,391,28/01/2023,Sports,False,4360265006895,0.0,2061.06,299465.94,Important,dakshita
391,392,28/01/2023,Home,True,4234240271924,1517.09,0.0,297948.85,Non-Essential,dakshita
392,393,28/01/2023,Electronics,False,4308849568171,0.0,482.47,298431.32,Important,dakshita
393,394,28/01/2023,Games,False,4386123199820,0.0,2756.63,301187.95,Important,dakshita
394,395,28/01/2023,Automotive,False,4336783233310,0.0,817.36,302005.31,Important,dakshita
395,396,28/01/2023,Clothing,True,4390310279782,400.63,0.0,301604.68,Non-Essential,dakshita
396,397,28/01/2023,Music,True,4328527846466,2460.91,0.0,299143.77,Important,dakshita
397,398,28/01/2023,Music,True,4748623118729,1538.35,0.0,297605.42,Non-Essential,dakshita
398,399,29/01/2023,Baby,True,4602558756486,1426.82,0.0,296178.6,Important,dakshita
399,400,29/01/2023,Home,True,4932564496973,173.47,0.0,296005.13,Important,dakshita
400,401,29/01/2023,Automotive,True,4061305702544,1466.82,0.0,294538.31,Important,dakshita
401,402,29/01/2023,Automotive,False,4226655741803,0.0,492.47,295030.78,Important,dakshita
402,403,29/01/2023,Music,False,4260665726372,0.0,2743.27,297774.05,Non-important,dakshita
403,404,29/01/2023,Music,True,4905606592291,611.39,0.0,297162.66,Important,dakshita
404,405,29/01/2023,Books,False,4498058876981,0.0,686.28,297848.94,Essential,dakshita
405,406,29/01/2023,Sports,True,4095148104203,744.79,0.0,297104.15,Essential,dakshita
406,407,29/01/2023,Outdoors,False,4143475796753,0.0,287.74,297391.89,Non-important,dakshita
407,408,29/01/2023,Tools,True,4092537440057,1291.61,0.0,296100.28,Important,dakshita
408,409,29/01/2023,Computers,True,4882944984637,2918.11,0.0,293182.17,Important,dakshita
409,410,29/01/2023,Computers,False,4244811774623,0.0,1212.45,294394.62,Non-Essential,dakshita
410,411,29/01/2023,Home,True,4110656117261,462.91,0.0,293931.71,Non-Essential,dakshita
411,412,30/01/2023,Garden,True,4497705312257,1499.17,0.0,292432.54,Non-Essential,dakshita
412,413,30/01/2023,Jewelry,True,4044657630919,540.35,0.0,291892.19,Essential,dakshita
413,414,30/01/2023,Electronics,False,4647689482250,0.0,1978.87,293871.06,Non-Essential,dakshita
414,415,30/01/2023,Books,True,4772405328100,2994.97,0.0,290876.09,Essential,dakshita
415,416,30/01/2023,Tools,True,4843852362089,836.07,0.0,290040.02,Essential,dakshita
416,417,30/01/2023,Automotive,True,4138858414395,1667.27,0.0,288372.75,Non-important,dakshita
417,418,31/01/2023,Shoes,False,4439396937779,0.0,2918.69,291291.44,Non-important,dakshita
418,419,31/01/2023,Garden,False,4192866045669,0.0,2054.09,293345.53,Non-Essential,dakshita
419,420,31/01/2023,Home,False,4395977821864,0.0,107.74,293453.27,Essential,dakshita
420,421,31/01/2023,Jewelry,True,4139770388729,2589.93,0.0,290863.34,Essential,dakshita
421,422,31/01/2023,Health,False,4572817345081,0.0,760.53,291623.87,Non-Essential,dakshita
422,423,31/01/2023,Sports,False,4650342412080,0.0,884.07,292507.94,Important,dakshita
423,424,31/01/2023,Games,True,4180617065159,625.9,0.0,291882.04,Non-Essential,dakshita
424,425,31/01/2023,Outdoors,False,4862814597205,0.0,2353.25,294235.29,Non-Essential,dakshita
425,426,01/02/2023,Movies,True,4571972671736,1518.65,0.0,292716.64,Non-Essential,dakshita
426,427,01/02/2023,Books,True,4631080827673,2191.39,0.0,290525.25,Non-important,dakshita
427,428,01/02/2023,Health,False,4987070061527,0.0,1812.19,292337.44,Essential,dakshita
428,429,01/02/2023,Grocery,True,4910999496793,1638.72,0.0,290698.72,Non-important,dakshita
429,430,01/02/2023,Outdoors,False,4102772211974,0.0,77.49,290776.21,Essential,dakshita
430,431,01/02/2023,Tools,False,4839716159823,0.0,2492.99,293269.2,Non-important,dakshita
431,432,01/02/2023,Beauty,False,4289881183146,0.0,369.76,293638.96,Essential,dakshita
432,433,01/02/2023,Electronics,True,4729398679362,2205.85,0.0,291433.11,Important,dakshita
433,434,02/02/2023,Clothing,False,4304377639911,0.0,2128.52,293561.63,Non-important,dakshita
434,435,02/02/2023,Beauty,True,4074050999535,231.31,0.0,293330.32,Non-important,dakshita
435,436,02/02/2023,Computers,True,4858454084968,825.12,0.0,292505.2,Important,dakshita
436,437,02/02/2023,Garden,False,4992001055340,0.0,491.34,292996.54,Important,dakshita
437,438,02/02/2023,Outdoors,False,4910866925394,0.0,1863.45,294859.99,Non-important,dakshita
438,439,02/02/2023,Shoes,True,4150827145271,106.49,0.0,294753.5,Important,dakshita
439,440,02/02/2023,Health,True,4835381639175,1114.93,0.0,293638.57,Non-important,dakshita
440,441,02/02/2023,Movies,False,4068153412423,0.0,205.76,293844.33,Non-Essential,dakshita
441,442,02/02/2023,Music,False,4927435560705,0.0,2330.38,296174.71,Important,dakshita
442,443,02/02/2023,Kids,False,4560920810639,0.0,1212.96,297387.67,Non-Essential,dakshita
443,444,02/02/2023,Shoes,True,4066702839646,1377.55,0.0,296010.12,Essential,dakshita
444,445,02/02/2023,Electronics,False,4099546139349,0.0,2509.23,298519.35,Essential,dakshita
445,446,02/02/2023,Books,False,4005238685694,0.0,2577.66,301097.01,Important,dakshita
446,447,03/02/2023,Kids,False,4716941214908,0.0,1570.46,302667.47,Non-important,dakshita
447,448,03/02/2023,Clothing,False,4727584028592,0.0,2670.15,305337.62,Important,dakshita
448,449,03/02/2023,Grocery,True,4516984797424,2498.24,0.0,302839.38,Non-important,dakshita
449,450,03/02/2023,Music,True,4294128433553,1517.01,0.0,301322.37,Non-Essential,dakshita
450,451,03/02/2023,Clothing,True,4251546446152,1716.27,0.0,299606.1,Essential,dakshita
451,452,03/02/2023,Clothing,False,4946699626705,0.0,2512.18,302118.28,Non-Essential,dakshita
452,453,03/02/2023,Grocery,True,4039863546361,2360.68,0.0,299757.6,Non-important,dakshita
453,454,04/02/2023,Garden,True,4117699636370,597.03,0.0,299160.57,Non-Essential,dakshita
454,455,04/02/2023,Outdoors,False,4968284601724,0.0,720.47,299881.04,Essential,dakshita
455,456,04/02/2023,Music,True,4162671237987,1773.41,0.0,298107.63,Non-Essential,dakshita
456,457,04/02/2023,Grocery,True,4645948572035,2035.56,0.0,296072.07,Non-important,dakshita
457,458,04/02/2023,Games,False,4455298313718,0.0,782.31,296854.38,Non-important,dakshita
458,459,04/02/2023,Home,False,4979108070237,0.0,2027.76,298882.14,Non-Essential,dakshita
459,460,04/02/2023,Music,False,4289049115615,0.0,521.14,299403.28,Non-Essential,dakshita
460,461,04/02/2023,Kids,True,4809868122734,558.63,0.0,298844.65,Non-Essential,dakshita
461,462,04/02/2023,Home,True,4291391651934,1886.96,0.0,296957.69,Non-important,dakshita
462,463,05/02/2023,Music,True,4135069527237,1916.55,0.0,295041.14,Essential,dakshita
463,464,05/02/2023,Industrial,False,4453076093986,0.0,1416.01,296457.15,Essential,dakshita
464,465,05/02/2023,Games,False,4685786700841,0.0,686.42,297143.57,Essential,dakshita
465,466,05/02/2023,Toys,False,4707885324005,0.0,2862.71,300006.28,Non-Essential,dakshita
466,467,05/02/2023,Garden,True,4712826505541,1954.75,0.0,298051.53,Essential,dakshita
467,468,05/02/2023,Home,True,4412637417059,837.26,0.0,297214.27,Essential,dakshita
468,469,05/02/2023,Kids,True,4448067385865,855.01,0.0,296359.26,Essential,dakshita
469,470,05/02/2023,Shoes,True,4983738950312,894.77,0.0,295464.49,Non-Essential,dakshita
470,471,05/02/2023,Kids,True,4381172179085,130.15,0.0,295334.34,Essential,dakshita
471,472,06/02/2023,Electronics,False,4347450093052,0.0,2244.8,297579.14,Non-important,dakshita
472,473,06/02/2023,Tools,False,4806024405574,0.0,603.11,298182.25,Important,dakshita
473,474,06/02/2023,Movies,True,4528600902797,971.74,0.0,297210.51,Important,dakshita
474,475,06/02/2023,Health,False,4523803544646,0.0,677.05,297887.56,Important,dakshita
475,476,06/02/2023,Grocery,False,4432580640893,0.0,1094.06,298981.62,Non-important,dakshita
476,477,06/02/2023,Baby,True,4965083262777,1833.78,0.0,297147.84,Non-Essential,dakshita
477,478,06/02/2023,Tools,True,4490047551340,1458.71,0.0,295689.13,Non-important,dakshita
478,479,06/02/2023,Toys,True,4159418853773,144.08,0.0,295545.05,Non-Essential,dakshita
479,480,06/02/2023,Baby,True,4348274164093,963.43,0.0,294581.62,Non-Essential,dakshita
480,481,06/02/2023,Electronics,False,4573900713232,0.0,2252.26,296833.88,Non-important,dakshita
481,482,06/02/2023,Books,False,4919805945065,0.0,185.23,297019.11,Essential,dakshita
482,483,06/02/2023,Outdoors,True,4192779206285,1564.27,0.0,295454.84,Important,dakshita
483,484,06/02/2023,Automotive,False,4212757904764,0.0,2175.02,297629.86,Non-important,dakshita
484,485,07/02/2023,Computers,False,4382870385307,0.0,1566.14,299196.0,Essential,dakshita
485,486,07/02/2023,Tools,False,4512976518090,0.0,2434.57,301630.57,Non-Essential,dakshita
486,487,07/02/2023,Computers,False,4467358569404,0.0,1315.07,302945.64,Important,dakshita
487,488,07/02/2023,Jewelry,False,4572224260939,0.0,2180.57,305126.21,Non-important,dakshita
488,489,07/02/2023,Toys,True,4453289335748,1289.57,0.0,303836.64,Important,dakshita
489,490,07/02/2023,Jewelry,True,4111601411271,2312.57,0.0,301524.07,Essential,dakshita
490,491,08/02/2023,Beauty,False,4385315607332,0.0,650.32,302174.39,Non-Essential,dakshita
491,492,08/02/2023,Baby,True,4922571371458,33.96,0.0,302140.43,Non-Essential,dakshita
492,493,08/02/2023,Baby,True,4188210244360,454.34,0.0,301686.09,Essential,dakshita
493,494,08/02/2023,Health,True,4211170937976,2542.07,0.0,299144.02,Essential,dakshita
494,495,08/02/2023,Sports,False,4231195876085,0.0,1604.28,300748.3,Important,dakshita
495,496,08/02/2023,Outdoors,False,4625315786835,0.0,1735.68,302483.98,Important,dakshita
496,497,08/02/2023,Baby,True,4827091386349,1519.02,0.0,300964.96,Non-Essential,dakshita
497,498,08/02/2023,Beauty,True,4820315156333,1590.78,0.0,299374.18,Important,dakshita
498,499,08/02/2023,Computers,True,4536279176395,2201.17,0.0,297173.01,Important,dakshita
499,500,08/02/2023,Computers,False,4293050768086,0.0,344.29,297517.3,Non-Essential,dakshita
500,501,08/02/2023,Beauty,False,4757325016233,0.0,2241.92,299759.22,Essential,dakshita
501,502,08/02/2023,Clothing,False,4723060432382,0.0,2397.8,302157.02,Non-Essential,dakshita
502,503,08/02/2023,Toys,True,4327819270998,2910.87,0.0,299246.15,Essential,dakshita
503,504,08/02/2023,Toys,False,4323550788760,0.0,1201.97,300448.12,Non-important,dakshita
504,505,08/02/2023,Jewelry,True,4235217149879,1668.53,0.0,298779.59,Essential,dakshita
505,506,08/02/2023,Baby,True,4715061869665,2518.3,0.0,296261.29,Essential,dakshita
506,507,08/02/2023,Automotive,False,4729549121195,0.0,1358.04,297619.33,Non-important,dakshita
507,508,08/02/2023,Beauty,False,4560679327781,0.0,1102.58,298721.91,Non-Essential,dakshita
508,509,08/02/2023,Health,False,4006438778737,0.0,1878.41,300600.32,Non-important,dakshita
509,510,09/02/2023,Tools,False,4538553549803,0.0,2991.86,303592.18,Important,dakshita
510,511,09/02/2023,Books,True,4093216402905,1350.17,0.0,302242.01,Non-important,dakshita
511,512,09/02/2023,Tools,False,4448378555076,0.0,220.22,302462.23,Non-Essential,dakshita
512,513,09/02/2023,Tools,False,4434986967595,0.0,1725.74,304187.97,Non-Essential,dakshita
513,514,09/02/2023,Automotive,True,4464878891631,1154.95,0.0,303033.02,Essential,dakshita
514,515,09/02/2023,Music,False,4502939769888,0.0,264.78,303297.8,Important,dakshita
515,516,09/02/2023,Home,False,4000529503175,0.0,368.66,303666.46,Non-Essential,dakshita
516,517,09/02/2023,Movies,False,4338776482173,0.0,1831.52,305497.98,Essential,dakshita
517,518,09/02/2023,Music,False,4187088353354,0.0,1720.09,307218.07,Non-important,dakshita
518,519,10/02/2023,Clothing,False,4627028987683,0.0,1064.14,308282.21,Important,dakshita
519,520,10/02/2023,Outdoors,False,4918202960075,0.0,965.03,309247.24,Essential,dakshita
520,521,10/02/2023,Industrial,False,4304041833861,0.0,1202.59,310449.83,Non-important,dakshita
521,522,10/02/2023,Shoes,False,4950344137682,0.0,37.43,310487.26,Essential,dakshita
522,523,10/02/2023,Baby,False,4299810745104,0.0,314.28,310801.54,Non-important,dakshita
523,524,10/02/2023,Games,False,4200120643091,0.0,1073.87,311875.41,Important,dakshita
524,525,10/02/2023,Toys,False,4498636372427,0.0,1807.02,313682.43,Important,dakshita
525,526,11/02/2023,Games,False,4814475151031,0.0,1854.19,315536.62,Important,dakshita
526,527,11/02/2023,Electronics,True,4251140156775,2891.05,0.0,312645.57,Non-important,dakshita
527,528,11/02/2023,Garden,False,4665619019933,0.0,2687.27,315332.84,Essential,dakshita
528,529,11/02/2023,Home,True,4698754229237,45.74,0.0,315287.1,Essential,dakshita
529,530,11/02/2023,Shoes,False,4240150234849,0.0,2852.21,318139.31,Non-Essential,dakshita
530,531,11/02/2023,Music,True,4787296700394,859.34,0.0,317279.97,Important,dakshita
531,532,11/02/2023,Beauty,True,4292500749733,2268.65,0.0,315011.32,Non-important,dakshita
532,533,11/02/2023,Home,False,4585659815995,0.0,1994.34,317005.66,Non-important,dakshita
533,534,11/02/2023,Outdoors,False,4215266904543,0.0,1087.57,318093.23,Essential,dakshita
534,535,11/02/2023,Beauty,True,4438796341506,120.44,0.0,317972.79,Non-important,dakshita
535,536,11/02/2023,Music,True,4670491009961,2338.67,0.0,315634.12,Important,dakshita
536,537,11/02/2023,Outdoors,True,4010780685103,2060.48,0.0,313573.64,Important,dakshita
537,538,11/02/2023,Outdoors,True,4690951037540,789.35,0.0,312784.29,Non-Essential,dakshita
538,539,11/02/2023,Movies,True,4024413810995,1204.06,0.0,311580.23,Essential,dakshita
539,540,12/02/2023,Automotive,False,4977484502241,0.0,21.25,311601.48,Non-Essential,dakshita
540,541,12/02/2023,Tools,False,4455329763292,0.0,829.44,312430.92,Non-Essential,dakshita
541,542,12/02/2023,Games,True,4492021661385,1961.53,0.0,310469.39,Non-Essential,dakshita
542,543,12/02/2023,Electronics,True,4519238927502,2792.92,0.0,307676.47,Important,dakshita
543,544,12/02/2023,Health,True,4984465001849,2384.88,0.0,305291.59,Non-important,dakshita
544,545,12/02/2023,Baby,False,4248002990633,0.0,981.13,306272.72,Important,dakshita
545,546,12/02/2023,Outdoors,True,4558993490950,210.84,0.0,306061.88,Non-important,dakshita
546,547,12/02/2023,Automotive,True,4095202742574,2064.55,0.0,303997.33,Non-important,dakshita
547,548,12/02/2023,Beauty,False,4916766710863,0.0,1003.46,305000.79,Essential,dakshita
548,549,12/02/2023,Games,True,4003398726969,2211.19,0.0,302789.6,Non-Essential,dakshita
549,550,12/02/2023,Home,True,4977185461798,1068.63,0.0,301720.97,Non-Essential,dakshita
550,551,12/02/2023,Beauty,True,4845659240236,65.36,0.0,301655.61,Important,dakshita
551,552,12/02/2023,Electronics,False,4764771076539,0.0,1660.18,303315.79,Important,dakshita
552,553,12/02/2023,Books,False,4949239878839,0.0,1342.56,304658.35,Essential,dakshita
553,554,12/02/2023,Home,True,4365225012354,372.48,0.0,304285.87,Non-important,dakshita
554,555,12/02/2023,Books,True,4042343345106,318.91,0.0,303966.96,Non-important,dakshita
555,556,12/02/2023,Music,True,4663327781856,431.57,0.0,303535.39,Essential,dakshita
556,557,12/02/2023,Games,True,4648516349311,1680.44,0.0,301854.95,Non-Essential,dakshita
557,558,12/02/2023,Electronics,False,4215014736595,0.0,150.25,302005.2,Important,dakshita
558,559,13/02/2023,Toys,False,4702871242140,0.0,2667.11,304672.31,Essential,dakshita
559,560,13/02/2023,Sports,False,4340871433589,0.0,73.98,304746.29,Important,dakshita
560,561,13/02/2023,Music,True,4878001919419,2277.08,0.0,302469.21,Important,dakshita
561,562,13/02/2023,Jewelry,True,4609380805321,2195.94,0.0,300273.27,Essential,dakshita
562,563,13/02/2023,Sports,False,4305209955740,0.0,663.26,300936.53,Non-Essential,dakshita
563,564,13/02/2023,Grocery,True,4609788482863,2004.31,0.0,298932.22,Essential,dakshita
564,565,13/02/2023,Grocery,True,4714446329261,2230.24,0.0,296701.98,Essential,dakshita
565,566,13/02/2023,Movies,False,4496165673892,0.0,2230.4,298932.38,Non-Essential,dakshita
566,567,13/02/2023,Tools,True,4334916168571,808.69,0.0,298123.69,Important,dakshita
567,568,14/02/2023,Beauty,False,4436649559833,0.0,2884.09,301007.78,Non-important,dakshita
568,569,14/02/2023,Tools,False,4300331756765,0.0,1464.76,302472.54,Non-Essential,dakshita
569,570,14/02/2023,Beauty,False,4560330598230,0.0,2750.4,305222.94,Non-Essential,dakshita
570,571,14/02/2023,Sports,False,4953634262272,0.0,2109.61,307332.55,Non-important,dakshita
571,572,14/02/2023,Beauty,True,4912647617199,2084.2,0.0,305248.35,Non-Essential,dakshita
572,573,14/02/2023,Industrial,True,4422543568925,2436.42,0.0,302811.93,Non-Essential,dakshita
573,574,14/02/2023,Games,True,4638353686750,795.03,0.0,302016.9,Important,dakshita
574,575,14/02/2023,Jewelry,False,4806067511348,0.0,1728.64,303745.54,Essential,dakshita
575,576,14/02/2023,Clothing,False,4967926325961,0.0,1063.24,304808.78,Non-Essential,dakshita
576,577,14/02/2023,Games,True,4680962097399,417.14,0.0,304391.64,Non-Essential,dakshita
577,578,14/02/2023,Shoes,False,4722308962503,0.0,1887.87,306279.51,Important,dakshita
578,579,14/02/2023,Shoes,True,4293819910236,1498.98,0.0,304780.53,Essential,dakshita
579,580,14/02/2023,Sports,True,4728059765221,2878.19,0.0,301902.34,Important,dakshita
580,581,14/02/2023,Music,True,4300163987304,235.85,0.0,301666.49,Non-important,dakshita
581,582,14/02/2023,Computers,False,4668861247460,0.0,2466.74,304133.23,Important,dakshita
582,583,14/02/2023,Music,False,4935054545367,0.0,389.4,304522.63,Important,dakshita
583,584,14/02/2023,Industrial,True,4404133406906,2035.16,0.0,302487.47,Non-Essential,dakshita
584,585,14/02/2023,Electronics,True,4242678455082,2002.19,0.0,300485.28,Important,dakshita
585,586,14/02/2023,Jewelry,True,4453175795829,1548.86,0.0,298936.42,Essential,dakshita
586,587,15/02/2023,Shoes,True,4613784277657,2743.67,0.0,296192.75,Essential,dakshita
587,588,15/02/2023,Industrial,True,4779222109443,480.36,0.0,295712.39,Non-important,dakshita
588,589,15/02/2023,Industrial,True,4821669357363,1118.05,0.0,294594.34,Non-Essential,dakshita
589,590,15/02/2023,Garden,True,4887191998619,2262.02,0.0,292332.32,Non-important,dakshita
590,591,15/02/2023,Computers,False,4781439418637,0.0,1156.7,293489.02,Essential,dakshita
591,592,15/02/2023,Tools,True,4291455887959,2342.54,0.0,291146.48,Essential,dakshita
592,593,15/02/2023,Outdoors,False,4176437796473,0.0,1266.87,292413.35,Important,dakshita
593,594,15/02/2023,Electronics,False,4450234441621,0.0,139.49,292552.84,Non-important,dakshita
594,595,15/02/2023,Toys,False,4494843308210,0.0,265.58,292818.42,Non-Essential,dakshita
595,596,15/02/2023,Kids,True,4837233389652,1287.15,0.0,291531.27,Important,dakshita
596,597,15/02/2023,Industrial,True,4866379201037,1436.54,0.0,290094.73,Important,dakshita
597,598,15/02/2023,Kids,True,4719969685351,54.72,0.0,290040.01,Non-Essential,dakshita
598,599,15/02/2023,Music,True,4322341979528,102.23,0.0,289937.78,Non-Essential,dakshita
599,600,16/02/2023,Shoes,False,4788337860637,0.0,2732.67,292670.45,Non-Essential,dakshita
600,601,16/02/2023,Movies,True,4421330117108,2773.9,0.0,289896.55,Non-Essential,dakshita
601,602,16/02/2023,Kids,True,4091643498092,1265.38,0.0,288631.17,Non-important,dakshita
602,603,16/02/2023,Shoes,False,4520704300534,0.0,2642.37,291273.54,Important,dakshita
603,604,16/02/2023,Shoes,False,4597205807700,0.0,2787.1,294060.64,Essential,dakshita
604,605,16/02/2023,Health,True,4818783193225,409.13,0.0,293651.51,Non-Essential,dakshita
605,606,16/02/2023,Grocery,False,4250544846490,0.0,2474.99,296126.5,Essential,dakshita
606,607,16/02/2023,Outdoors,False,4149904161419,0.0,1296.48,297422.98,Non-important,dakshita
607,608,16/02/2023,Industrial,False,4473173249213,0.0,1690.84,299113.82,Essential,dakshita
608,609,16/02/2023,Health,False,4812473824792,0.0,1327.91,300441.73,Essential,dakshita
609,610,17/02/2023,Automotive,False,4833786629639,0.0,2240.62,302682.35,Important,dakshita
610,611,17/02/2023,Jewelry,False,4641409527743,0.0,1412.9,304095.25,Important,dakshita
611,612,17/02/2023,Music,False,4355289208487,0.0,1582.4,305677.65,Non-Essential,dakshita
612,613,17/02/2023,Grocery,True,4839403491345,2297.34,0.0,303380.31,Essential,dakshita
613,614,17/02/2023,Shoes,True,4519503076429,2102.66,0.0,301277.65,Essential,dakshita
614,615,17/02/2023,Outdoors,False,4293381796967,0.0,2246.6,303524.25,Non-important,dakshita
615,616,17/02/2023,Electronics,False,4908688825705,0.0,1808.81,305333.06,Essential,dakshita
616,617,17/02/2023,Music,False,4918544455694,0.0,1292.04,306625.1,Important,dakshita
617,618,17/02/2023,Garden,True,4143831748816,2003.48,0.0,304621.62,Non-Essential,dakshita
618,619,17/02/2023,Garden,True,4249243333261,1833.58,0.0,302788.04,Non-important,dakshita
619,620,17/02/2023,Electronics,False,4549823178924,0.0,2212.58,305000.62,Important,dakshita
620,621,17/02/2023,Games,True,4233792525583,1141.18,0.0,303859.44,Essential,dakshita
621,622,17/02/2023,Music,True,4168229613071,2938.02,0.0,300921.42,Non-Essential,dakshita
622,623,17/02/2023,Kids,True,4334636859166,2065.11,0.0,298856.31,Non-Essential,dakshita
623,624,18/02/2023,Industrial,False,4076279344277,0.0,1689.02,300545.33,Important,dakshita
624,625,18/02/2023,Outdoors,True,4512148266773,1236.12,0.0,299309.21,Important,dakshita
625,626,18/02/2023,Clothing,False,4119169526900,0.0,340.2,299649.41,Non-important,dakshita
626,627,18/02/2023,Electronics,False,4614069430428,0.0,199.11,299848.52,Essential,dakshita
627,628,18/02/2023,Jewelry,True,4889494262745,47.18,0.0,299801.34,Non-important,dakshita
628,629,18/02/2023,Health,False,4182170326952,0.0,1615.09,301416.43,Non-Essential,dakshita
629,630,18/02/2023,Music,False,4456923120766,0.0,1736.55,303152.98,Non-Essential,dakshita
630,631,18/02/2023,Games,False,4786386841224,0.0,1905.54,305058.52,Non-important,dakshita
631,632,18/02/2023,Clothing,True,4551522350652,2422.54,0.0,302635.98,Important,dakshita
632,633,18/02/2023,Grocery,True,4297541226739,264.96,0.0,302371.02,Non-Essential,dakshita
633,634,19/02/2023,Beauty,False,4702961043838,0.0,1189.71,303560.73,Essential,dakshita
634,635,19/02/2023,Jewelry,False,4586020093849,0.0,557.77,304118.5,Non-important,dakshita
635,636,19/02/2023,Computers,False,4216262253129,0.0,2398.02,306516.52,Essential,dakshita
636,637,19/02/2023,Books,False,4363688807989,0.0,531.37,307047.89,Important,dakshita
637,638,19/02/2023,Industrial,True,4489165854084,912.64,0.0,306135.25,Non-important,dakshita
638,639,19/02/2023,Automotive,False,4812011434163,0.0,2921.84,309057.09,Non-important,dakshita
639,640,19/02/2023,Grocery,True,4092180226895,2514.81,0.0,306542.28,Non-Essential,dakshita
640,641,19/02/2023,Jewelry,True,4488894327331,2646.37,0.0,303895.91,Essential,dakshita
641,642,19/02/2023,Music,True,4057262860437,2907.83,0.0,300988.08,Non-important,dakshita
642,643,20/02/2023,Industrial,False,4283506350727,0.0,2368.72,303356.8,Important,dakshita
643,644,20/02/2023,Outdoors,False,4559633125307,0.0,1326.16,304682.96,Non-important,dakshita
644,645,20/02/2023,Jewelry,True,4840753118907,1894.98,0.0,302787.98,Essential,dakshita
645,646,20/02/2023,Health,False,4937345911286,0.0,2313.68,305101.66,Non-important,dakshita
646,647,20/02/2023,Outdoors,True,4387328171953,1786.27,0.0,303315.39,Important,dakshita
647,648,20/02/2023,Music,False,4802433386363,0.0,2941.15,306256.54,Essential,dakshita
648,649,20/02/2023,Toys,True,4843936492621,1249.19,0.0,305007.35,Essential,dakshita
649,650,20/02/2023,Computers,True,4571832988498,1594.72,0.0,303412.63,Important,dakshita
650,651,20/02/2023,Health,False,4575137119402,0.0,919.35,304331.98,Non-Essential,dakshita
651,652,20/02/2023,Kids,False,4128215762994,0.0,894.56,305226.54,Essential,dakshita
652,653,20/02/2023,Sports,False,4651003805855,0.0,2273.39,307499.93,Important,dakshita
653,654,20/02/2023,Shoes,False,4040063277935,0.0,2624.52,310124.45,Non-Essential,dakshita
654,655,20/02/2023,Home,False,4715791268812,0.0,1052.02,311176.47,Non-important,dakshita
655,656,20/02/2023,Clothing,False,4312854988249,0.0,1180.91,312357.38,Essential,dakshita
656,657,20/02/2023,Outdoors,False,4450226516233,0.0,880.21,313237.59,Essential,dakshita
657,658,20/02/2023,Home,True,4419252438010,2769.19,0.0,310468.4,Non-Essential,dakshita
658,659,20/02/2023,Baby,True,4785862462519,624.9,0.0,309843.5,Important,dakshita
659,660,20/02/2023,Jewelry,True,4821474546389,1828.98,0.0,308014.52,Non-important,dakshita
660,661,20/02/2023,Beauty,True,4906025966440,1727.87,0.0,306286.65,Non-Essential,dakshita
661,662,20/02/2023,Computers,True,4937437914111,183.41,0.0,306103.24,Important,dakshita
662,663,20/02/2023,Shoes,False,4666275090343,0.0,2273.06,308376.3,Essential,dakshita
663,664,21/02/2023,Automotive,False,4150759950087,0.0,2618.63,310994.93,Non-important,dakshita
664,665,21/02/2023,Sports,True,4807620325544,1793.06,0.0,309201.87,Essential,dakshita
665,666,21/02/2023,Computers,True,4698428367822,1969.59,0.0,307232.28,Essential,dakshita
666,667,21/02/2023,Tools,True,4210041880093,2749.95,0.0,304482.33,Important,dakshita
667,668,21/02/2023,Jewelry,False,4407078006335,0.0,1437.18,305919.51,Non-Essential,dakshita
668,669,21/02/2023,Kids,False,4260252471949,0.0,1034.8,306954.31,Non-Essential,dakshita
669,670,21/02/2023,Grocery,True,4322255111336,319.19,0.0,306635.12,Essential,dakshita
670,671,21/02/2023,Music,True,4252277137081,647.05,0.0,305988.07,Non-Essential,dakshita
671,672,21/02/2023,Home,False,4209004571358,0.0,2959.93,308948.0,Essential,dakshita
672,673,21/02/2023,Home,True,4971596310099,2750.72,0.0,306197.28,Non-Essential,dakshita
673,674,21/02/2023,Computers,False,4735818851135,0.0,2083.27,308280.55,Non-important,dakshita
674,675,21/02/2023,Movies,False,4158121910853,0.0,1630.23,309910.78,Non-important,dakshita
675,676,21/02/2023,Garden,True,4264659834484,529.63,0.0,309381.15,Non-important,dakshita
676,677,21/02/2023,Home,False,4991366781297,0.0,2256.47,311637.62,Non-important,dakshita
677,678,21/02/2023,Shoes,True,4774102462068,2238.9,0.0,309398.72,Non-Essential,dakshita
678,679,21/02/2023,Kids,True,4389030379030,426.75,0.0,308971.97,Non-Essential,dakshita
679,680,22/02/2023,Games,True,4979935969084,589.92,0.0,308382.05,Essential,dakshita
680,681,22/02/2023,Industrial,True,4898303270643,2732.99,0.0,305649.06,Essential,dakshita
681,682,22/02/2023,Baby,True,4731501862887,2544.28,0.0,303104.78,Non-important,dakshita
682,683,22/02/2023,Garden,False,4090263795236,0.0,2981.54,306086.32,Essential,dakshita
683,684,22/02/2023,Beauty,True,4735848172557,2246.36,0.0,303839.96,Non-important,dakshita
684,685,22/02/2023,Shoes,False,4271955581095,0.0,802.18,304642.14,Essential,dakshita
685,686,22/02/2023,Movies,True,4249647719839,268.04,0.0,304374.1,Important,dakshita
686,687,22/02/2023,Shoes,False,4414763386874,0.0,92.35,304466.45,Non-important,dakshita
687,688,22/02/2023,Tools,True,4386926846340,420.9,0.0,304045.55,Essential,dakshita
688,689,22/02/2023,Shoes,True,4096885015126,574.03,0.0,303471.52,Essential,dakshita
689,690,22/02/2023,Home,True,4640802345297,1197.09,0.0,302274.43,Essential,dakshita
690,691,22/02/2023,Garden,True,4838206208212,2484.55,0.0,299789.88,Non-important,dakshita
691,692,22/02/2023,Shoes,True,4755321447853,2520.82,0.0,297269.06,Non-important,dakshita
692,693,22/02/2023,Electronics,False,4852112599705,0.0,805.99,298075.05,Non-Essential,dakshita
693,694,22/02/2023,Industrial,True,4320350348544,569.73,0.0,297505.32,Essential,dakshita
694,695,22/02/2023,Books,True,4897943409590,2245.14,0.0,295260.18,Essential,dakshita
695,696,23/02/2023,Toys,True,4361641512072,1823.36,0.0,293436.82,Non-Essential,dakshita
696,697,23/02/2023,Garden,False,4248165803654,0.0,2161.47,295598.29,Non-important,dakshita
697,698,23/02/2023,Beauty,False,4410634790508,0.0,1769.44,297367.73,Essential,dakshita
698,699,23/02/2023,Music,True,4760405626690,321.01,0.0,297046.72,Non-Essential,dakshita
699,700,23/02/2023,Kids,True,4206032498868,912.0,0.0,296134.72,Non-Essential,dakshita
700,701,23/02/2023,Jewelry,True,4562458637894,1593.1,0.0,294541.62,Non-Essential,dakshita
701,702,23/02/2023,Tools,False,4132198783448,0.0,490.27,295031.89,Non-important,dakshita
702,703,23/02/2023,Home,True,4907803655017,1370.87,0.0,293661.02,Essential,dakshita
703,704,23/02/2023,Kids,True,4576305221546,2769.24,0.0,290891.78,Essential,dakshita
704,705,23/02/2023,Books,False,4448864863828,0.0,995.62,291887.4,Non-Essential,dakshita
705,706,23/02/2023,Automotive,False,4901223672176,0.0,2169.84,294057.24,Non-important,dakshita
706,707,23/02/2023,Games,True,4074743605411,2896.85,0.0,291160.39,Important,dakshita
707,708,23/02/2023,Outdoors,True,4534865024842,2932.25,0.0,288228.14,Important,dakshita
708,709,24/02/2023,Health,True,4114488456410,1588.13,0.0,286640.01,Essential,dakshita
709,710,24/02/2023,Kids,True,4848877670454,2014.86,0.0,284625.15,Non-Essential,dakshita
710,711,24/02/2023,Tools,True,4740903529872,2647.09,0.0,281978.06,Non-important,dakshita
711,712,24/02/2023,Garden,True,4413779836555,2397.59,0.0,279580.47,Non-important,dakshita
712,713,24/02/2023,Baby,True,4155418065781,2336.83,0.0,277243.64,Important,dakshita
713,714,24/02/2023,Grocery,True,4108032500024,2502.41,0.0,274741.23,Non-Essential,dakshita
714,715,24/02/2023,Automotive,True,4980639105450,668.31,0.0,274072.92,Important,dakshita
715,716,24/02/2023,Movies,True,4526454379263,2564.64,0.0,271508.28,Non-Essential,dakshita
716,717,24/02/2023,Baby,True,4679260324324,1993.36,0.0,269514.92,Non-important,dakshita
717,718,24/02/2023,Kids,True,4398399815101,2812.98,0.0,266701.94,Important,dakshita
718,719,24/02/2023,Outdoors,True,4445093168216,2633.14,0.0,264068.8,Non-Essential,dakshita
719,720,25/02/2023,Sports,True,4651176210539,1289.43,0.0,262779.37,Important,dakshita
720,721,25/02/2023,Jewelry,False,4252584311927,0.0,336.31,263115.68,Important,dakshita
721,722,25/02/2023,Beauty,False,4705118952437,0.0,210.48,263326.16,Essential,dakshita
722,723,25/02/2023,Kids,False,4363241215841,0.0,871.15,264197.31,Essential,dakshita
723,724,26/02/2023,Baby,False,4686654617120,0.0,2395.15,266592.46,Essential,dakshita
724,725,26/02/2023,Clothing,True,4526328872879,678.73,0.0,265913.73,Essential,dakshita
725,726,26/02/2023,Movies,False,4586027438072,0.0,2737.41,268651.14,Important,dakshita
726,727,26/02/2023,Home,True,4929605412236,580.55,0.0,268070.59,Non-important,dakshita
727,728,26/02/2023,Movies,True,4625830571747,2291.06,0.0,265779.53,Important,dakshita
728,729,26/02/2023,Kids,True,4907981654095,2785.42,0.0,262994.11,Essential,dakshita
729,730,26/02/2023,Clothing,True,4153226633230,2358.69,0.0,260635.42,Non-Essential,dakshita
730,731,26/02/2023,Beauty,False,4483490597425,0.0,918.51,261553.93,Important,dakshita
731,732,26/02/2023,Kids,False,4029937961859,0.0,2227.32,263781.25,Non-important,dakshita
732,733,26/02/2023,Baby,True,4551024169561,2940.76,0.0,260840.49,Non-Essential,dakshita
733,734,26/02/2023,Computers,False,4956781369235,0.0,168.35,261008.84,Non-important,dakshita
734,735,26/02/2023,Toys,False,4781716663650,0.0,2193.77,263202.61,Non-important,dakshita
735,736,27/02/2023,Beauty,False,4968582550074,0.0,950.23,264152.84,Non-Essential,dakshita
736,737,27/02/2023,Clothing,False,4098122349679,0.0,1118.71,265271.55,Essential,dakshita
737,738,27/02/2023,Electronics,True,4548527520384,2667.15,0.0,262604.4,Essential,dakshita
738,739,27/02/2023,Kids,True,4185453074630,256.65,0.0,262347.75,Non-important,dakshita
739,740,27/02/2023,Electronics,False,4106218410056,0.0,1193.16,263540.91,Important,dakshita
740,741,27/02/2023,Books,False,4663040796936,0.0,1617.14,265158.05,Important,dakshita
741,742,28/02/2023,Beauty,False,4253836500164,0.0,1435.43,266593.48,Non-Essential,dakshita
742,743,28/02/2023,Clothing,False,4215863882324,0.0,1075.27,267668.75,Important,dakshita
743,744,28/02/2023,Kids,False,4212492997760,0.0,1798.25,269467.0,Essential,dakshita
744,745,28/02/2023,Beauty,False,4197992178662,0.0,1988.19,271455.19,Non-important,dakshita
745,746,28/02/2023,Garden,True,4160777965598,1907.5,0.0,269547.69,Essential,dakshita
746,747,28/02/2023,Grocery,True,4946743636001,989.27,0.0,268558.42,Essential,dakshita
747,748,28/02/2023,Tools,True,4713625894144,1656.07,0.0,266902.35,Non-Essential,dakshita
748,749,28/02/2023,Music,True,4870551508268,26.25,0.0,266876.1,Non-important,dakshita
749,750,28/02/2023,Kids,True,4679526827233,2484.39,0.0,264391.71,Essential,dakshita
750,751,28/02/2023,Industrial,False,4728329538988,0.0,2220.05,266611.76,Non-Essential,dakshita
751,752,28/02/2023,Baby,True,4524094377769,1176.7,0.0,265435.06,Non-Essential,dakshita
752,753,28/02/2023,Beauty,False,4964829141574,0.0,1709.16,267144.22,Essential,dakshita
753,754,28/02/2023,Electronics,False,4502350568380,0.0,863.16,268007.38,Essential,dakshita
754,755,28/02/2023,Jewelry,False,4851222409735,0.0,2095.05,270102.43,Non-Essential,dakshita
755,756,01/03/2023,Baby,True,4849726573098,993.98,0.0,269108.45,Non-important,dakshita
756,757,01/03/2023,Kids,True,4639587411000,1778.49,0.0,267329.96,Essential,dakshita
757,758,01/03/2023,Baby,True,4999504618308,2061.62,0.0,265268.34,Non-important,dakshita
758,759,01/03/2023,Clothing,False,4833535417412,0.0,1949.63,267217.97,Essential,dakshita
759,760,01/03/2023,Outdoors,False,4169931479323,0.0,248.66,267466.63,Non-important,dakshita
760,761,01/03/2023,Automotive,True,4097742332286,562.48,0.0,266904.15,Important,dakshita
761,762,01/03/2023,Games,True,4040304849962,1933.77,0.0,264970.38,Non-important,dakshita
762,763,01/03/2023,Games,False,4914763893603,0.0,1841.44,266811.82,Non-Essential,dakshita
763,764,01/03/2023,Health,False,4427058389438,0.0,2628.28,269440.1,Non-important,dakshita
764,765,01/03/2023,Tools,True,4066819436430,2300.71,0.0,267139.39,Non-Essential,dakshita
765,766,01/03/2023,Shoes,False,4723059634902,0.0,838.07,267977.46,Non-Essential,dakshita
766,767,01/03/2023,Sports,True,4241762055561,864.37,0.0,267113.09,Important,dakshita
767,768,02/03/2023,Games,True,4644166821826,1196.35,0.0,265916.74,Important,dakshita
768,769,02/03/2023,Health,False,4103815828072,0.0,2455.05,268371.79,Non-Essential,dakshita
769,770,02/03/2023,Computers,False,4458530100268,0.0,1278.18,269649.97,Non-important,dakshita
770,771,02/03/2023,Health,False,4678087954191,0.0,2440.74,272090.71,Essential,dakshita
771,772,02/03/2023,Grocery,True,4550652103935,287.92,0.0,271802.79,Non-important,dakshita
772,773,02/03/2023,Tools,False,4903715156421,0.0,2979.81,274782.6,Non-Essential,dakshita
773,774,02/03/2023,Computers,True,4696785570272,2347.43,0.0,272435.17,Important,dakshita
774,775,02/03/2023,Industrial,False,4968113955032,0.0,1544.18,273979.35,Essential,dakshita
775,776,02/03/2023,Health,True,4865946009118,745.3,0.0,273234.05,Non-Essential,dakshita
776,777,02/03/2023,Clothing,True,4708587510373,1733.46,0.0,271500.59,Non-Essential,dakshita
777,778,02/03/2023,Garden,False,4579471504235,0.0,547.54,272048.13,Essential,dakshita
778,779,02/03/2023,Books,False,4613173021932,0.0,2674.71,274722.84,Non-Essential,dakshita
779,780,02/03/2023,Automotive,False,4103142820106,0.0,1760.29,276483.13,Non-important,dakshita
780,781,02/03/2023,Kids,False,4375672309382,0.0,1797.12,278280.25,Essential,dakshita
781,782,02/03/2023,Garden,True,4323503064739,758.84,0.0,277521.41,Essential,dakshita
782,783,03/03/2023,Clothing,False,4263047281085,0.0,565.92,278087.33,Non-Essential,dakshita
783,784,03/03/2023,Tools,False,4002763786411,0.0,1560.43,279647.76,Important,dakshita
784,785,03/03/2023,Movies,False,4178274123649,0.0,2103.6,281751.36,Non-Essential,dakshita
785,786,03/03/2023,Beauty,True,4409980775539,475.24,0.0,281276.12,Important,dakshita
786,787,03/03/2023,Home,True,4154616392139,2404.88,0.0,278871.24,Non-Essential,dakshita
787,788,03/03/2023,Games,False,4553305490366,0.0,520.61,279391.85,Essential,dakshita
788,789,03/03/2023,Automotive,True,4295352890161,436.12,0.0,278955.73,Non-Essential,dakshita
789,790,03/03/2023,Tools,True,4031631860394,2183.07,0.0,276772.66,Non-important,dakshita
790,791,03/03/2023,Beauty,False,4616725428842,0.0,2258.46,279031.12,Non-Essential,dakshita
791,792,04/03/2023,Outdoors,False,4875106497130,0.0,860.2,279891.32,Essential,dakshita
792,793,04/03/2023,Computers,False,4024102643560,0.0,1163.77,281055.09,Non-Essential,dakshita
793,794,04/03/2023,Music,False,4489921308850,0.0,456.87,281511.96,Non-Essential,dakshita
794,795,04/03/2023,Electronics,True,4052717660572,1308.79,0.0,280203.17,Important,dakshita
795,796,04/03/2023,Games,True,4334964425214,1286.47,0.0,278916.7,Non-important,dakshita
796,797,04/03/2023,Jewelry,True,4979209236315,1888.37,0.0,277028.33,Non-Essential,dakshita
797,798,04/03/2023,Movies,True,4751996734534,253.71,0.0,276774.62,Non-Essential,dakshita
798,799,05/03/2023,Home,True,4966856316701,1647.22,0.0,275127.4,Non-Essential,dakshita
799,800,05/03/2023,Books,False,4047974875375,0.0,1256.78,276384.18,Non-important,dakshita
800,801,05/03/2023,Music,True,4553134712951,2092.39,0.0,274291.79,Important,dakshita
801,802,05/03/2023,Kids,True,4755905241227,488.45,0.0,273803.34,Non-important,dakshita
802,803,05/03/2023,Grocery,False,4376293093382,0.0,2837.88,276641.22,Essential,dakshita
803,804,05/03/2023,Outdoors,True,4710766041419,221.22,0.0,276420.0,Essential,dakshita
804,805,05/03/2023,Clothing,False,4800100591647,0.0,2271.18,278691.18,Non-important,dakshita
805,806,05/03/2023,Outdoors,True,4203822848554,2135.01,0.0,276556.17,Important,dakshita
806,807,05/03/2023,Clothing,False,4007997356091,0.0,539.49,277095.66,Essential,dakshita
807,808,05/03/2023,Electronics,False,4085307022802,0.0,2149.71,279245.37,Non-important,dakshita
808,809,05/03/2023,Jewelry,False,4405952393393,0.0,2414.19,281659.56,Important,dakshita
809,810,05/03/2023,Home,False,4330525729914,0.0,1626.47,283286.03,Non-important,dakshita
810,811,06/03/2023,Garden,False,4307233758638,0.0,2191.15,285477.18,Non-important,dakshita
811,812,06/03/2023,Shoes,False,4881124581509,0.0,1349.87,286827.05,Essential,dakshita
812,813,06/03/2023,Garden,True,4542973881139,2671.72,0.0,284155.33,Essential,dakshita
813,814,06/03/2023,Electronics,True,4456659683669,970.92,0.0,283184.41,Essential,dakshita
814,815,06/03/2023,Clothing,False,4015310809219,0.0,202.9,283387.31,Essential,dakshita
815,816,06/03/2023,Garden,True,4995563471241,388.99,0.0,282998.32,Essential,dakshita
816,817,06/03/2023,Industrial,False,4758278329057,0.0,1078.78,284077.1,Important,dakshita
817,818,06/03/2023,Computers,False,4258985805019,0.0,2662.99,286740.09,Important,dakshita
818,819,06/03/2023,Industrial,False,4548694289872,0.0,1287.56,288027.65,Non-Essential,dakshita
819,820,06/03/2023,Tools,True,4316802268021,143.89,0.0,287883.76,Essential,dakshita
820,821,06/03/2023,Home,False,4000414241304,0.0,2492.17,290375.93,Important,dakshita
821,822,06/03/2023,Home,True,4723438357822,1057.26,0.0,289318.67,Essential,dakshita
822,823,06/03/2023,Jewelry,False,4646173771194,0.0,1360.63,290679.3,Non-important,dakshita
823,824,07/03/2023,Kids,False,4796290525470,0.0,819.32,291498.62,Non-Essential,dakshita
824,825,07/03/2023,Music,False,4206329245281,0.0,468.59,291967.21,Non-Essential,dakshita
825,826,07/03/2023,Home,False,4837810255784,0.0,232.74,292199.95,Non-important,dakshita
826,827,07/03/2023,Baby,True,4437208295701,209.28,0.0,291990.67,Important,dakshita
827,828,07/03/2023,Books,False,4768473769363,0.0,2985.05,294975.72,Essential,dakshita
828,829,07/03/2023,Kids,False,4766700440055,0.0,1133.32,296109.04,Essential,dakshita
829,830,07/03/2023,Computers,False,4589783984646,0.0,2441.38,298550.42,Important,dakshita
830,831,07/03/2023,Games,True,4151970447421,739.4,0.0,297811.02,Essential,dakshita
831,832,07/03/2023,Games,False,4668137523845,0.0,2005.43,299816.45,Non-important,dakshita
832,833,08/03/2023,Computers,False,4610113676969,0.0,1999.98,301816.43,Essential,dakshita
833,834,08/03/2023,Games,False,4151868422372,0.0,1436.92,303253.35,Essential,dakshita
834,835,08/03/2023,Home,False,4272144549874,0.0,875.03,304128.38,Important,dakshita
835,836,08/03/2023,Movies,True,4910795290098,2031.2,0.0,302097.18,Non-important,dakshita
836,837,08/03/2023,Tools,False,4091465228317,0.0,434.58,302531.76,Important,dakshita
837,838,08/03/2023,Baby,False,4414812680433,0.0,1566.45,304098.21,Non-Essential,dakshita
838,839,08/03/2023,Music,True,4491667393022,969.97,0.0,303128.24,Important,dakshita
839,840,08/03/2023,Garden,False,4205299758431,0.0,2839.58,305967.82,Non-Essential,dakshita
840,841,08/03/2023,Books,False,4389582706281,0.0,1433.59,307401.41,Essential,dakshita
841,842,08/03/2023,Electronics,True,4962039661846,2711.93,0.0,304689.48,Non-Essential,dakshita
842,843,08/03/2023,Industrial,True,4426971267051,1968.18,0.0,302721.3,Non-Essential,dakshita
843,844,09/03/2023,Outdoors,False,4013707925068,0.0,2446.15,305167.45,Non-Essential,dakshita
844,845,09/03/2023,Tools,True,4619517302194,182.45,0.0,304985.0,Non-important,dakshita
845,846,09/03/2023,Health,False,4695909242608,0.0,2505.84,307490.84,Non-important,dakshita
846,847,09/03/2023,Movies,False,4658516818559,0.0,2055.16,309546.0,Essential,dakshita
847,848,09/03/2023,Garden,False,4152674928187,0.0,916.28,310462.28,Important,dakshita
848,849,09/03/2023,Shoes,False,4647116612909,0.0,1683.7,312145.98,Non-important,dakshita
849,850,09/03/2023,Books,False,4960045433742,0.0,8.13,312154.11,Important,dakshita
850,851,09/03/2023,Electronics,False,4166184375351,0.0,962.61,313116.72,Non-Essential,dakshita
851,852,09/03/2023,Tools,True,4914331573111,1073.21,0.0,312043.51,Non-Essential,dakshita
852,853,09/03/2023,Beauty,False,4574399494772,0.0,587.31,312630.82,Non-important,dakshita
853,854,09/03/2023,Outdoors,True,4658151911840,1376.88,0.0,311253.94,Non-important,dakshita
854,855,10/03/2023,Movies,False,4754211231712,0.0,1363.17,312617.11,Important,dakshita
855,856,10/03/2023,Games,False,4738752068469,0.0,1109.56,313726.67,Essential,dakshita
856,857,10/03/2023,Music,False,4687769263287,0.0,2935.16,316661.83,Important,dakshita
857,858,10/03/2023,Books,True,4412646842745,2701.35,0.0,313960.48,Non-Essential,dakshita
858,859,10/03/2023,Clothing,True,4292690001995,2773.03,0.0,311187.45,Essential,dakshita
859,860,10/03/2023,Grocery,False,4279229574280,0.0,1458.37,312645.82,Non-Essential,dakshita
860,861,10/03/2023,Garden,True,4939987508810,1587.41,0.0,311058.41,Important,dakshita
861,862,10/03/2023,Computers,True,4220346659705,762.02,0.0,310296.39,Important,dakshita
862,863,11/03/2023,Industrial,True,4254778898201,1460.38,0.0,308836.01,Non-Essential,dakshita
863,864,11/03/2023,Sports,True,4908124924949,1478.5,0.0,307357.51,Non-important,dakshita
864,865,11/03/2023,Computers,True,4725891299050,57.65,0.0,307299.86,Important,dakshita
865,866,11/03/2023,Kids,False,4069378996003,0.0,878.45,308178.31,Important,dakshita
866,867,11/03/2023,Books,False,4201276526234,0.0,1763.6,309941.91,Essential,dakshita
867,868,11/03/2023,Books,False,4352524178068,0.0,1576.27,311518.18,Non-important,dakshita
868,869,11/03/2023,Toys,True,4343932170205,1380.43,0.0,310137.75,Non-Essential,dakshita
869,870,11/03/2023,Automotive,True,4825871524055,2860.95,0.0,307276.8,Important,dakshita
870,871,11/03/2023,Movies,False,4840291439714,0.0,2974.37,310251.17,Essential,dakshita
871,872,11/03/2023,Outdoors,True,4896904676588,1419.51,0.0,308831.66,Essential,dakshita
872,873,12/03/2023,Outdoors,True,4300564612897,535.45,0.0,308296.21,Non-important,dakshita
873,874,12/03/2023,Home,True,4733336448366,2161.92,0.0,306134.29,Essential,dakshita
874,875,12/03/2023,Outdoors,False,4119610659257,0.0,522.13,306656.42,Essential,dakshita
875,876,12/03/2023,Jewelry,False,4377640677516,0.0,509.29,307165.71,Essential,dakshita
876,877,12/03/2023,Automotive,False,4837191322796,0.0,2344.13,309509.84,Non-Essential,dakshita
877,878,12/03/2023,Garden,True,4618154450810,1956.63,0.0,307553.21,Non-important,dakshita
878,879,12/03/2023,Garden,False,4664313204636,0.0,975.5,308528.71,Essential,dakshita
879,880,12/03/2023,Movies,True,4745484705936,2177.11,0.0,306351.6,Important,dakshita
880,881,12/03/2023,Toys,False,4699528597187,0.0,2527.44,308879.04,Essential,dakshita
881,882,12/03/2023,Movies,False,4837502055448,0.0,1484.96,310364.0,Non-important,dakshita
882,883,12/03/2023,Clothing,False,4831667456963,0.0,1262.26,311626.26,Non-Essential,dakshita
883,884,12/03/2023,Kids,False,4517787281732,0.0,920.68,312546.94,Non-Essential,dakshita
884,885,13/03/2023,Baby,True,4892013030286,2068.17,0.0,310478.77,Important,dakshita
885,886,13/03/2023,Garden,False,4975682977001,0.0,1668.65,312147.42,Essential,dakshita
886,887,13/03/2023,Beauty,True,4024394189540,2011.4,0.0,310136.02,Essential,dakshita
887,888,13/03/2023,Books,False,4240380498144,0.0,2520.49,312656.51,Non-Essential,dakshita
888,889,13/03/2023,Clothing,True,4231217395492,1433.96,0.0,311222.55,Non-important,dakshita
889,890,13/03/2023,Outdoors,True,4252337821844,1386.11,0.0,309836.44,Important,dakshita
890,891,13/03/2023,Automotive,False,4801777723968,0.0,1812.53,311648.97,Non-important,dakshita
891,892,13/03/2023,Games,True,4816832177342,1309.12,0.0,310339.85,Essential,dakshita
892,893,13/03/2023,Toys,True,4989640966491,2647.53,0.0,307692.32,Important,dakshita
893,894,13/03/2023,Kids,True,4732736859057,162.16,0.0,307530.16,Essential,dakshita
894,895,13/03/2023,Tools,False,4217559564577,0.0,2259.06,309789.22,Essential,dakshita
895,896,13/03/2023,Sports,True,4064641000239,96.35,0.0,309692.87,Essential,dakshita
896,897,14/03/2023,Books,False,4515469299458,0.0,1623.33,311316.2,Non-Essential,dakshita
897,898,14/03/2023,Home,False,4435489568407,0.0,2863.6,314179.8,Non-important,dakshita
898,899,14/03/2023,Automotive,False,4076579708833,0.0,32.13,314211.93,Essential,dakshita
899,900,14/03/2023,Shoes,False,4030669647759,0.0,1526.23,315738.16,Non-Essential,dakshita
900,901,14/03/2023,Sports,False,4586741219992,0.0,1096.69,316834.85,Essential,dakshita
901,902,14/03/2023,Computers,True,4197080235798,22.07,0.0,316812.78,Non-important,dakshita
902,903,15/03/2023,Outdoors,False,4365501807377,0.0,2451.08,319263.86,Important,dakshita
903,904,15/03/2023,Clothing,True,4489387918265,1290.08,0.0,317973.78,Non-important,dakshita
904,905,15/03/2023,Industrial,False,4998238375277,0.0,1864.1,319837.88,Non-important,dakshita
905,906,15/03/2023,Books,False,4795023919326,0.0,2469.55,322307.43,Non-Essential,dakshita
906,907,15/03/2023,Garden,False,4844451002109,0.0,101.06,322408.49,Non-important,dakshita
907,908,15/03/2023,Industrial,False,4076152576593,0.0,1051.89,323460.38,Non-important,dakshita
908,909,15/03/2023,Grocery,True,4585465042434,2808.78,0.0,320651.6,Non-Essential,dakshita
909,910,15/03/2023,Health,False,4761217314110,0.0,2658.95,323310.55,Important,dakshita
910,911,15/03/2023,Kids,False,4853566667664,0.0,368.69,323679.24,Non-Essential,dakshita
911,912,16/03/2023,Industrial,False,4458896579236,0.0,2418.81,326098.05,Non-Essential,dakshita
912,913,16/03/2023,Movies,False,4756373432943,0.0,2038.01,328136.06,Non-important,dakshita
913,914,16/03/2023,Sports,False,4972644301407,0.0,2027.95,330164.01,Essential,dakshita
914,915,16/03/2023,Books,True,4908712268041,2667.83,0.0,327496.18,Essential,dakshita
915,916,16/03/2023,Grocery,True,4811607122481,66.18,0.0,327430.0,Important,dakshita
916,917,16/03/2023,Kids,True,4968030892615,906.92,0.0,326523.08,Essential,dakshita
917,918,16/03/2023,Grocery,False,4726626339746,0.0,130.4,326653.48,Non-Essential,dakshita
918,919,16/03/2023,Books,False,4764001600531,0.0,2103.86,328757.34,Important,dakshita
919,920,16/03/2023,Clothing,False,4169317783547,0.0,2409.8,331167.14,Essential,dakshita
920,921,16/03/2023,Kids,False,4045930845557,0.0,564.26,331731.4,Non-Essential,dakshita
921,922,16/03/2023,Music,False,4438373520223,0.0,2239.5,333970.9,Non-Essential,dakshita
922,923,16/03/2023,Baby,True,4763165613006,1214.47,0.0,332756.43,Non-important,dakshita
923,924,17/03/2023,Jewelry,False,4177034651769,0.0,2494.35,335250.78,Essential,dakshita
924,925,17/03/2023,Shoes,False,4622239095241,0.0,1817.14,337067.92,Non-important,dakshita
925,926,17/03/2023,Games,False,4258686634629,0.0,952.1,338020.02,Non-Essential,dakshita
926,927,17/03/2023,Baby,True,4704532332275,1078.93,0.0,336941.09,Essential,dakshita
927,928,17/03/2023,Clothing,False,4360115754149,0.0,981.6,337922.69,Important,dakshita
928,929,17/03/2023,Computers,False,4305874865266,0.0,2653.72,340576.41,Non-Essential,dakshita
929,930,17/03/2023,Jewelry,False,4490180961473,0.0,1471.88,342048.29,Essential,dakshita
930,931,17/03/2023,Automotive,True,4979775793976,665.8,0.0,341382.49,Important,dakshita
931,932,18/03/2023,Industrial,False,4388022741128,0.0,1248.59,342631.08,Essential,dakshita
932,933,18/03/2023,Sports,False,4696749143123,0.0,2599.78,345230.86,Non-important,dakshita
933,934,18/03/2023,Music,False,4810047405405,0.0,1581.23,346812.09,Important,dakshita
934,935,18/03/2023,Jewelry,False,4846648849637,0.0,1922.45,348734.54,Essential,dakshita
935,936,18/03/2023,Tools,True,4650638624110,541.11,0.0,348193.43,Important,dakshita
936,937,18/03/2023,Sports,False,4220115911486,0.0,1697.85,349891.28,Non-Essential,dakshita
937,938,19/03/2023,Kids,True,4314195882081,653.52,0.0,349237.76,Essential,dakshita
938,939,19/03/2023,Tools,True,4052984642842,48.43,0.0,349189.33,Non-important,dakshita
939,940,19/03/2023,Home,False,4003960470455,0.0,1466.67,350656.0,Non-Essential,dakshita
940,941,19/03/2023,Clothing,False,4540927950841,0.0,616.55,351272.55,Non-Essential,dakshita
941,942,19/03/2023,Automotive,True,4416052827049,2931.44,0.0,348341.11,Essential,dakshita
942,943,19/03/2023,Outdoors,True,4889566518679,297.56,0.0,348043.55,Important,dakshita
943,944,19/03/2023,Beauty,True,4475352172843,2780.95,0.0,345262.6,Non-important,dakshita
944,945,19/03/2023,Clothing,False,4598848056070,0.0,2203.65,347466.25,Important,dakshita
945,946,19/03/2023,Jewelry,False,4481929368644,0.0,1666.38,349132.63,Non-important,dakshita
946,947,19/03/2023,Tools,False,4152061455172,0.0,2904.43,352037.06,Important,dakshita
947,948,19/03/2023,Movies,False,4770617829118,0.0,2114.2,354151.26,Important,dakshita
948,949,19/03/2023,Toys,True,4210179454037,1181.1,0.0,352970.16,Essential,dakshita
949,950,19/03/2023,Toys,True,4873219662036,1155.12,0.0,351815.04,Important,dakshita
950,951,20/03/2023,Movies,True,4142120849399,2872.85,0.0,348942.19,Essential,dakshita
951,952,20/03/2023,Books,True,4950951091606,2342.06,0.0,346600.13,Non-Essential,dakshita
952,953,20/03/2023,Garden,False,4320760952814,0.0,102.86,346702.99,Non-important,dakshita
953,954,20/03/2023,Tools,True,4386886423511,725.0,0.0,345977.99,Non-Essential,dakshita
954,955,20/03/2023,Grocery,False,4067267466013,0.0,2854.17,348832.16,Non-important,dakshita
955,956,20/03/2023,Music,False,4047595803319,0.0,2451.52,351283.68,Non-Essential,dakshita
956,957,20/03/2023,Garden,False,4356496567070,0.0,1724.54,353008.22,Important,dakshita
957,958,20/03/2023,Home,True,4143682366835,2763.49,0.0,350244.73,Important,dakshita
958,959,20/03/2023,Baby,False,4085527288743,0.0,874.09,351118.82,Non-important,dakshita
959,960,20/03/2023,Industrial,True,4674447204302,1701.52,0.0,349417.3,Non-important,dakshita
960,961,20/03/2023,Electronics,True,4264990378932,1844.87,0.0,347572.43,Non-Essential,dakshita
961,962,20/03/2023,Games,True,4533131596380,154.85,0.0,347417.58,Essential,dakshita
962,963,20/03/2023,Beauty,True,4390857678774,2751.35,0.0,344666.23,Essential,dakshita
963,964,20/03/2023,Books,False,4775590736701,0.0,48.49,344714.72,Non-Essential,dakshita
964,965,20/03/2023,Games,True,4949789563862,2204.06,0.0,342510.66,Non-important,dakshita
965,966,20/03/2023,Books,True,4203840154668,1696.59,0.0,340814.07,Important,dakshita
966,967,21/03/2023,Music,True,4855945176899,2281.52,0.0,338532.55,Non-important,dakshita
967,968,21/03/2023,Beauty,True,4740517783545,1069.99,0.0,337462.56,Non-important,dakshita
968,969,21/03/2023,Movies,True,4208465381574,1431.41,0.0,336031.15,Non-Essential,dakshita
969,970,21/03/2023,Clothing,True,4032197809033,628.51,0.0,335402.64,Non-important,dakshita
970,971,21/03/2023,Baby,False,4184067417720,0.0,1649.34,337051.98,Essential,dakshita
971,972,21/03/2023,Tools,False,4779281896376,0.0,2104.19,339156.17,Essential,dakshita
972,973,21/03/2023,Books,True,4295719081951,856.16,0.0,338300.01,Non-important,dakshita
973,974,21/03/2023,Toys,False,4582756417657,0.0,1651.28,339951.29,Important,dakshita
974,975,21/03/2023,Automotive,False,4341550152864,0.0,363.48,340314.77,Non-important,dakshita
975,976,21/03/2023,Tools,True,4905555023706,1755.08,0.0,338559.69,Important,dakshita
976,977,21/03/2023,Games,True,4993489153732,2874.79,0.0,335684.9,Non-important,dakshita
977,978,21/03/2023,Baby,True,4141574715016,1544.5,0.0,334140.4,Non-important,dakshita
978,979,21/03/2023,Music,False,4066760069231,0.0,506.14,334646.54,Non-Essential,dakshita
979,980,21/03/2023,Shoes,False,4952485744690,0.0,1477.74,336124.28,Important,dakshita
980,981,21/03/2023,Electronics,True,4273870467297,2246.04,0.0,333878.24,Non-important,dakshita
981,982,21/03/2023,Books,True,4152897471315,1929.99,0.0,331948.25,Important,dakshita
982,983,21/03/2023,Industrial,True,4376141224609,295.11,0.0,331653.14,Non-important,dakshita
983,984,22/03/2023,Outdoors,False,4530307844015,0.0,2661.33,334314.47,Important,dakshita
984,985,22/03/2023,Clothing,True,4559168351186,374.3,0.0,333940.17,Important,dakshita
985,986,22/03/2023,Music,True,4311350964768,2104.57,0.0,331835.6,Non-important,dakshita
986,987,22/03/2023,Grocery,False,4131380230655,0.0,2253.68,334089.28,Non-important,dakshita
987,988,22/03/2023,Garden,False,4457683326452,0.0,1890.01,335979.29,Essential,dakshita
988,989,22/03/2023,Industrial,True,4334730268685,599.03,0.0,335380.26,Non-Essential,dakshita
989,990,22/03/2023,Books,True,4509212638116,2863.82,0.0,332516.44,Non-important,dakshita
990,991,22/03/2023,Home,False,4933619184304,0.0,1346.63,333863.07,Non-important,dakshita
991,992,22/03/2023,Industrial,False,4427763840044,0.0,1581.32,335444.39,Important,dakshita
992,993,22/03/2023,Baby,True,4327358653511,2130.16,0.0,333314.23,Non-important,dakshita
993,994,22/03/2023,Outdoors,False,4123239610388,0.0,463.53,333777.76,Important,dakshita
994,995,22/03/2023,Toys,False,4662849075073,0.0,47.21,333824.97,Essential,dakshita
995,996,22/03/2023,Shoes,True,4789406911909,118.54,0.0,333706.43,Essential,dakshita
996,997,22/03/2023,Clothing,False,4646742365551,0.0,1218.19,334924.62,Important,dakshita
997,998,22/03/2023,Sports,True,4946106907103,1158.89,0.0,333765.73,Essential,dakshita
998,999,22/03/2023,Kids,False,4793107559986,0.0,1.26,333766.99,Essential,dakshita
999,1000,22/03/2023,Outdoors,True,4245756153840,355.25,0.0,333411.74,Non-important,dakshita
