,row,Txn Date,Description,Transfer To/From,Ref No./Cheque No.,Debit,Credit,Balance,Class,User
0,1,23/12/2022,Jewelry,True,3172376751536,15.03,0.0,691447.16,Essential,vedika
1,2,23/12/2022,Clothing,False,3047405612279,0.0,2173.29,693620.45,Essential,vedika
2,3,23/12/2022,Kids,True,3955134731593,2460.27,0.0,691160.18,Non-Essential,vedika
3,4,23/12/2022,Baby,True,3890881898497,891.91,0.0,690268.27,Non-important,vedika
4,5,23/12/2022,Home,True,3296868927279,1631.99,0.0,688636.28,Essential,vedika
5,6,23/12/2022,Toys,False,3056441772155,0.0,689.4,689325.68,Essential,vedika
6,7,23/12/2022,Shoes,True,3699479745208,4989.67,0.0,684336.01,Non-important,vedika
7,8,23/12/2022,Music,True,3523751436703,4198.53,0.0,680137.48,Essential,vedika
8,9,23/12/2022,Shoes,False,3746575115785,0.0,643.93,680781.41,Non-Essential,vedika
9,10,24/12/2022,Outdoors,True,3432664137502,3520.52,0.0,677260.89,Non-important,vedika
10,11,24/12/2022,Baby,True,3305347649067,3511.07,0.0,673749.82,Non-important,vedika
11,12,24/12/2022,Books,False,3202285334852,0.0,1241.94,674991.76,Important,vedika
12,13,24/12/2022,Games,False,3784996571812,0.0,488.0,675479.76,Non-Essential,vedika
13,14,24/12/2022,Beauty,True,3613455213765,1275.39,0.0,674204.37,Non-important,vedika
14,15,25/12/2022,Music,True,3703220364540,1538.4,0.0,672665.97,Essential,vedika
15,16,25/12/2022,Tools,True,3443367651780,2774.93,0.0,669891.04,Important,vedika
16,17,25/12/2022,Kids,False,3591045528851,0.0,2669.83,672560.87,Non-Essential,vedika
17,18,25/12/2022,Automotive,False,3778261626048,0.0,521.14,673082.01,Essential,vedika
18,19,25/12/2022,Tools,False,3442747352790,0.0,2641.67,675723.68,Important,vedika
19,20,25/12/2022,Health,False,3656371262961,0.0,210.67,675934.35,Essential,vedika
20,21,25/12/2022,Shoes,True,3948728892432,3203.2,0.0,672731.15,Non-Essential,vedika
21,22,25/12/2022,Computers,True,3231394930144,4658.91,0.0,668072.24,Non-important,vedika
22,23,25/12/2022,Music,False,3718594820389,0.0,2174.41,670246.65,Non-Essential,vedika
23,24,25/12/2022,Tools,False,3695980821675,0.0,1757.3,672003.95,Non-important,vedika
24,25,25/12/2022,Outdoors,True,3643505122042,2291.06,0.0,669712.89,Essential,vedika
25,26,26/12/2022,Beauty,False,3054120243934,0.0,810.5,670523.39,Non-Essential,vedika
26,27,26/12/2022,Clothing,True,3021911507517,21.66,0.0,670501.73,Essential,vedika
27,28,26/12/2022,Clothing,True,3526559521076,1747.41,0.0,668754.32,Non-important,vedika
28,29,26/12/2022,Music,False,3042229506209,0.0,1441.8,670196.12,Important,vedika
29,30,26/12/2022,Beauty,False,3145881822372,0.0,2708.31,672904.43,Non-Essential,vedika
30,31,26/12/2022,Jewelry,False,3090703241886,0.0,1598.0,674502.43,Non-important,vedika
31,32,26/12/2022,Clothing,False,3539894292892,0.0,1387.38,675889.81,Non-important,vedika
32,33,26/12/2022,Shoes,False,3040460257420,0.0,1913.7,677803.51,Essential,vedika
33,34,26/12/2022,Beauty,False,3206384519878,0.0,163.4,677966.91,Non-important,vedika
34,35,26/12/2022,Toys,True,3166603412596,2664.12,0.0,675302.79,Important,vedika
35,36,26/12/2022,Jewelry,True,3460086382586,1591.17,0.0,673711.62,Essential,vedika
36,37,26/12/2022,Movies,True,3600105840533,595.13,0.0,673116.49,Non-Essential,vedika
37,38,26/12/2022,Tools,False,3165161379646,0.0,344.77,673461.26,Essential,vedika
38,39,26/12/2022,Industrial,False,3172499171529,0.0,89.54,673550.8,Essential,vedika
39,40,26/12/2022,Garden,False,3616974696680,0.0,2193.78,675744.58,Non-important,vedika
40,41,26/12/2022,Jewelry,True,3424046824806,3675.07,0.0,672069.51,Non-Essential,vedika
41,42,27/12/2022,Books,False,3836933938749,0.0,689.5,672759.01,Important,vedika
42,43,27/12/2022,Outdoors,True,3887087039257,3822.3,0.0,668936.71,Important,vedika
43,44,27/12/2022,Kids,False,3455167212741,0.0,979.47,669916.18,Essential,vedika
44,45,27/12/2022,Computers,False,3607449326978,0.0,2049.5,671965.68,Non-Essential,vedika
45,46,27/12/2022,Baby,False,3295135229796,0.0,496.38,672462.06,Non-Essential,vedika
46,47,27/12/2022,Books,True,3029839882174,2930.53,0.0,669531.53,Important,vedika
47,48,27/12/2022,Kids,True,3080735963132,616.72,0.0,668914.81,Essential,vedika
48,49,27/12/2022,Automotive,True,3485424496036,2938.71,0.0,665976.1,Essential,vedika
49,50,27/12/2022,Games,False,3366641986085,0.0,758.37,666734.47,Essential,vedika
50,51,28/12/2022,Health,False,3351895786633,0.0,434.96,667169.43,Essential,vedika
51,52,28/12/2022,Shoes,True,3712996801805,225.4,0.0,666944.03,Non-important,vedika
52,53,28/12/2022,Tools,False,3464553491425,0.0,1828.69,668772.72,Important,vedika
53,54,28/12/2022,Books,False,3386119569582,0.0,894.08,669666.8,Non-Essential,vedika
54,55,28/12/2022,Electronics,False,3279379477642,0.0,2553.41,672220.21,Non-important,vedika
55,56,28/12/2022,Music,True,3033525883094,2811.91,0.0,669408.3,Essential,vedika
56,57,28/12/2022,Music,True,3766592880793,1225.64,0.0,668182.66,Non-important,vedika
57,58,28/12/2022,Sports,True,3271671930630,4951.88,0.0,663230.78,Non-important,vedika
58,59,28/12/2022,Movies,False,3930401454533,0.0,1158.56,664389.34,Essential,vedika
59,60,28/12/2022,Kids,False,3364021622929,0.0,714.23,665103.57,Essential,vedika
60,61,29/12/2022,Shoes,True,3245521795987,3231.97,0.0,661871.6,Important,vedika
61,62,29/12/2022,Movies,True,3929605567078,4278.14,0.0,657593.46,Important,vedika
62,63,29/12/2022,Kids,True,3403505783975,3154.42,0.0,654439.04,Non-important,vedika
63,64,29/12/2022,Automotive,False,3992847501479,0.0,479.9,654918.94,Non-important,vedika
64,65,29/12/2022,Shoes,False,3464748689235,0.0,1833.91,656752.85,Important,vedika
65,66,29/12/2022,Clothing,False,3415665250836,0.0,2508.77,659261.62,Essential,vedika
66,67,29/12/2022,Books,False,3317023515556,0.0,566.95,659828.57,Non-Essential,vedika
67,68,29/12/2022,Books,True,3419113112197,1387.54,0.0,658441.03,Important,vedika
68,69,29/12/2022,Tools,False,3076482846831,0.0,2952.08,661393.11,Essential,vedika
69,70,29/12/2022,Movies,False,3183307703765,0.0,2136.76,663529.87,Non-Essential,vedika
70,71,30/12/2022,Movies,True,3308004020520,1368.61,0.0,662161.26,Essential,vedika
71,72,30/12/2022,Movies,True,3463032196528,473.11,0.0,661688.15,Non-important,vedika
72,73,30/12/2022,Outdoors,False,3356553805024,0.0,2953.94,664642.09,Non-important,vedika
73,74,30/12/2022,Kids,True,3441042294957,3691.64,0.0,660950.45,Essential,vedika
74,75,31/12/2022,Kids,True,3279242799538,4511.9,0.0,656438.55,Non-Essential,vedika
75,76,31/12/2022,Garden,True,3713750921834,1494.48,0.0,654944.07,Non-Essential,vedika
76,77,31/12/2022,Books,False,3417406859122,0.0,1910.69,656854.76,Important,vedika
77,78,31/12/2022,Computers,True,3136524322955,4940.44,0.0,651914.32,Non-important,vedika
78,79,31/12/2022,Outdoors,False,3463158425413,0.0,2825.03,654739.35,Non-important,vedika
79,80,31/12/2022,Industrial,True,3802469166134,3124.85,0.0,651614.5,Important,vedika
80,81,31/12/2022,Outdoors,False,3205632138679,0.0,2554.47,654168.97,Important,vedika
81,82,31/12/2022,Tools,True,3962795980710,4260.57,0.0,649908.4,Essential,vedika
82,83,31/12/2022,Tools,True,3519141159623,977.91,0.0,648930.49,Non-Essential,vedika
83,84,31/12/2022,Shoes,True,3441351385590,84.39,0.0,648846.1,Essential,vedika
84,85,31/12/2022,Garden,True,3786548756261,3104.49,0.0,645741.61,Non-important,vedika
85,86,31/12/2022,Tools,False,3365499869646,0.0,1557.82,647299.43,Non-important,vedika
86,87,01/01/2023,Jewelry,True,3075727332651,2379.44,0.0,644919.99,Important,vedika
87,88,01/01/2023,Computers,True,3461594609906,725.29,0.0,644194.7,Non-Essential,vedika
88,89,01/01/2023,Tools,True,3422864900017,4844.75,0.0,639349.95,Non-important,vedika
89,90,01/01/2023,Clothing,True,3808567667500,472.15,0.0,638877.8,Essential,vedika
90,91,01/01/2023,Home,False,3084687121284,0.0,2495.25,641373.05,Essential,vedika
91,92,01/01/2023,Garden,False,3998323590449,0.0,1244.35,642617.4,Essential,vedika
92,93,01/01/2023,Sports,False,3230378432479,0.0,2379.24,644996.64,Non-Essential,vedika
93,94,01/01/2023,Baby,True,3729203416563,4507.5,0.0,640489.14,Essential,vedika
94,95,01/01/2023,Outdoors,False,3427373288481,0.0,2403.58,642892.72,Non-Essential,vedika
95,96,01/01/2023,Home,True,3379445361765,4577.42,0.0,638315.3,Essential,vedika
96,97,01/01/2023,Beauty,True,3175489454513,1942.85,0.0,636372.45,Important,vedika
97,98,01/01/2023,Garden,False,3982707547052,0.0,742.79,637115.24,Non-Essential,vedika
98,99,01/01/2023,Kids,True,3730439686161,4454.21,0.0,632661.03,Important,vedika
99,100,02/01/2023,Sports,False,3707706255177,0.0,1499.29,634160.32,Important,vedika
100,101,02/01/2023,Kids,True,3451166640191,1505.1,0.0,632655.22,Important,vedika
101,102,02/01/2023,Computers,True,3613190914451,4887.58,0.0,627767.64,Important,vedika
102,103,02/01/2023,Sports,True,3329298148073,2494.58,0.0,625273.06,Non-important,vedika
103,104,02/01/2023,Grocery,True,3310752240223,3447.19,0.0,621825.87,Important,vedika
104,105,02/01/2023,Jewelry,False,3736580712415,0.0,85.44,621911.31,Non-Essential,vedika
105,106,02/01/2023,Grocery,True,3421905246816,638.33,0.0,621272.98,Essential,vedika
106,107,02/01/2023,Beauty,True,3817499765675,1389.42,0.0,619883.56,Essential,vedika
107,108,02/01/2023,Home,False,3875860608506,0.0,1078.59,620962.15,Non-Essential,vedika
108,109,02/01/2023,Computers,False,3471663980156,0.0,1960.5,622922.65,Non-Essential,vedika
109,110,02/01/2023,Shoes,True,3681969505188,1361.41,0.0,621561.24,Important,vedika
110,111,02/01/2023,Kids,True,3198647175042,3163.71,0.0,618397.53,Non-Essential,vedika
111,112,02/01/2023,Toys,False,3477726276752,0.0,728.62,619126.15,Non-important,vedika
112,113,02/01/2023,Books,False,3136509159097,0.0,547.89,619674.04,Important,vedika
113,114,02/01/2023,Electronics,False,3124414434444,0.0,2092.16,621766.2,Important,vedika
114,115,02/01/2023,Clothing,False,3312078268917,0.0,1704.44,623470.64,Non-Essential,vedika
115,116,02/01/2023,Health,True,3946320509250,3534.24,0.0,619936.4,Non-Essential,vedika
116,117,03/01/2023,Health,True,3769523971250,1685.21,0.0,618251.19,Non-Essential,vedika
117,118,03/01/2023,Clothing,False,3438698167659,0.0,1910.83,620162.02,Non-Essential,vedika
118,119,03/01/2023,Health,False,3028664484946,0.0,2011.25,622173.27,Essential,vedika
119,120,03/01/2023,Automotive,False,3897124241928,0.0,2136.61,624309.88,Essential,vedika
120,121,03/01/2023,Industrial,True,3341113213643,2851.89,0.0,621457.99,Non-important,vedika
121,122,03/01/2023,Automotive,False,3082276366994,0.0,2915.82,624373.81,Important,vedika
122,123,03/01/2023,Electronics,True,3730503353978,1966.73,0.0,622407.08,Essential,vedika
123,124,03/01/2023,Movies,True,3490126778297,1637.84,0.0,620769.24,Essential,vedika
124,125,03/01/2023,Kids,False,3246459893072,0.0,1110.2,621879.44,Essential,vedika
125,126,03/01/2023,Industrial,False,3560610849637,0.0,370.08,622249.52,Non-Essential,vedika
126,127,03/01/2023,Health,False,3933012676958,0.0,17.63,622267.15,Non-Essential,vedika
127,128,03/01/2023,Grocery,True,3188926068466,736.38,0.0,621530.77,Essential,vedika
128,129,03/01/2023,Automotive,False,3773750352495,0.0,1441.44,622972.21,Important,vedika
129,130,03/01/2023,Health,True,3527330235667,499.26,0.0,622472.95,Non-important,vedika
130,131,03/01/2023,Computers,False,3903562342316,0.0,1513.9,623986.85,Non-Essential,vedika
131,132,04/01/2023,Movies,False,3659390182692,0.0,740.76,624727.61,Non-important,vedika
132,133,04/01/2023,Sports,False,3050924833617,0.0,1900.81,626628.42,Important,vedika
133,134,04/01/2023,Home,True,3181453130613,273.97,0.0,626354.45,Non-important,vedika
134,135,04/01/2023,Baby,False,3539525446042,0.0,2576.02,628930.47,Essential,vedika
135,136,04/01/2023,Automotive,True,3854269201320,797.37,0.0,628133.1,Essential,vedika
136,137,04/01/2023,Home,True,3014777560869,2811.66,0.0,625321.44,Non-important,vedika
137,138,04/01/2023,Baby,False,3986113413251,0.0,603.95,625925.39,Important,vedika
138,139,04/01/2023,Jewelry,True,3180746345551,12.63,0.0,625912.76,Non-important,vedika
139,140,04/01/2023,Books,True,3611938096801,3888.68,0.0,622024.08,Important,vedika
140,141,04/01/2023,Kids,False,3209142625122,0.0,2294.71,624318.79,Important,vedika
141,142,04/01/2023,Garden,True,3529557079237,584.81,0.0,623733.98,Essential,vedika
142,143,04/01/2023,Jewelry,True,3515812468710,748.96,0.0,622985.02,Non-Essential,vedika
143,144,05/01/2023,Garden,True,3674577703115,4114.25,0.0,618870.77,Non-important,vedika
144,145,05/01/2023,Health,False,3195366570375,0.0,2919.76,621790.53,Non-important,vedika
145,146,05/01/2023,Garden,True,3961833640304,1302.39,0.0,620488.14,Essential,vedika
146,147,05/01/2023,Games,False,3839203689172,0.0,1567.07,622055.21,Non-important,vedika
147,148,05/01/2023,Clothing,True,3892757942050,3031.43,0.0,619023.78,Essential,vedika
148,149,05/01/2023,Garden,True,3381444556025,737.51,0.0,618286.27,Non-important,vedika
149,150,05/01/2023,Movies,True,3915028739209,36.61,0.0,618249.66,Non-important,vedika
150,151,05/01/2023,Games,False,3918482080586,0.0,497.61,618747.27,Important,vedika
151,152,05/01/2023,Outdoors,False,3388201618823,0.0,2952.82,621700.09,Important,vedika
152,153,05/01/2023,Movies,False,3489432145065,0.0,2566.72,624266.81,Non-important,vedika
153,154,05/01/2023,Movies,False,3413567941372,0.0,2047.6,626314.41,Non-Essential,vedika
154,155,06/01/2023,Shoes,True,3858416126098,897.88,0.0,625416.53,Non-important,vedika
155,156,06/01/2023,Garden,False,3696313613503,0.0,1180.82,626597.35,Essential,vedika
156,157,06/01/2023,Jewelry,False,3767843682168,0.0,2542.98,629140.33,Important,vedika
157,158,06/01/2023,Baby,False,3792269827186,0.0,2568.63,631708.96,Non-Essential,vedika
158,159,06/01/2023,Beauty,True,3840147943283,1117.89,0.0,630591.07,Essential,vedika
159,160,06/01/2023,Sports,False,3446525328291,0.0,113.7,630704.77,Essential,vedika
160,161,06/01/2023,Shoes,False,3138299710408,0.0,1242.37,631947.14,Important,vedika
161,162,06/01/2023,Automotive,False,3305079013680,0.0,723.3,632670.44,Non-important,vedika
162,163,06/01/2023,Shoes,True,3377156590511,218.22,0.0,632452.22,Non-Essential,vedika
163,164,06/01/2023,Toys,False,3684587512505,0.0,2600.98,635053.2,Important,vedika
164,165,06/01/2023,Clothing,True,3088848913340,3705.37,0.0,631347.83,Non-Essential,vedika
165,166,06/01/2023,Outdoors,True,3157749488254,3425.1,0.0,627922.73,Non-Essential,vedika
166,167,07/01/2023,Kids,True,3793258943322,1362.01,0.0,626560.72,Essential,vedika
167,168,07/01/2023,Health,True,3479120500227,468.16,0.0,626092.56,Important,vedika
168,169,07/01/2023,Grocery,False,3969865717607,0.0,509.38,626601.94,Essential,vedika
169,170,07/01/2023,Music,True,3314922255473,1728.99,0.0,624872.95,Important,vedika
170,171,07/01/2023,Toys,False,3238357508773,0.0,2202.5,627075.45,Non-important,vedika
171,172,07/01/2023,Baby,False,3425301550667,0.0,2617.8,629693.25,Essential,vedika
172,173,07/01/2023,Computers,False,3900629373707,0.0,2697.69,632390.94,Important,vedika
173,174,07/01/2023,Automotive,False,3076775325707,0.0,1981.49,634372.43,Non-important,vedika
174,175,07/01/2023,Jewelry,True,3501929769452,4816.08,0.0,629556.35,Important,vedika
175,176,07/01/2023,Health,True,3873802440058,3883.44,0.0,625672.91,Non-important,vedika
176,177,07/01/2023,Kids,True,3256567078891,2079.22,0.0,623593.69,Non-Essential,vedika
177,178,08/01/2023,Automotive,True,3099124729851,1844.01,0.0,621749.68,Non-important,vedika
178,179,08/01/2023,Movies,False,3162400559189,0.0,2517.94,624267.62,Non-important,vedika
179,180,08/01/2023,Tools,False,3646733121659,0.0,1370.75,625638.37,Non-Essential,vedika
180,181,08/01/2023,Jewelry,False,3756501128852,0.0,192.9,625831.27,Non-important,vedika
181,182,08/01/2023,Movies,False,3466941774482,0.0,1055.24,626886.51,Non-important,vedika
182,183,08/01/2023,Shoes,False,3148524647601,0.0,683.29,627569.8,Essential,vedika
183,184,08/01/2023,Clothing,False,3009723975172,0.0,2409.22,629979.02,Important,vedika
184,185,08/01/2023,Clothing,True,3493792511420,2367.49,0.0,627611.53,Non-important,vedika
185,186,08/01/2023,Baby,True,3810380924462,1315.14,0.0,626296.39,Essential,vedika
186,187,08/01/2023,Toys,True,3161665293455,4229.31,0.0,622067.08,Essential,vedika
187,188,08/01/2023,Kids,False,3140326306226,0.0,2775.39,624842.47,Non-Essential,vedika
188,189,09/01/2023,Jewelry,True,3813747683243,4713.59,0.0,620128.88,Important,vedika
189,190,09/01/2023,Grocery,False,3087350354882,0.0,2125.44,622254.32,Non-Essential,vedika
190,191,09/01/2023,Industrial,True,3226263661979,2006.44,0.0,620247.88,Essential,vedika
191,192,09/01/2023,Tools,True,3305221402985,719.75,0.0,619528.13,Non-Essential,vedika
192,193,09/01/2023,Tools,True,3209015204769,1491.12,0.0,618037.01,Non-important,vedika
193,194,09/01/2023,Shoes,True,3030854923242,4049.67,0.0,613987.34,Non-important,vedika
194,195,09/01/2023,Shoes,True,3123048230898,1517.35,0.0,612469.99,Non-Essential,vedika
195,196,10/01/2023,Sports,False,3012061489059,0.0,2631.96,615101.95,Non-Essential,vedika
196,197,10/01/2023,Garden,False,3793708929560,0.0,320.05,615422.0,Essential,vedika
197,198,10/01/2023,Baby,True,3291452969492,566.45,0.0,614855.55,Non-important,vedika
198,199,10/01/2023,Jewelry,True,3532214251150,719.08,0.0,614136.47,Essential,vedika
199,200,10/01/2023,Outdoors,False,3307147331551,0.0,1110.66,615247.13,Non-important,vedika
200,201,10/01/2023,Shoes,True,3014210318301,1414.77,0.0,613832.36,Important,vedika
201,202,10/01/2023,Baby,True,3570290627583,2005.83,0.0,611826.53,Important,vedika
202,203,10/01/2023,Automotive,True,3229496450964,3283.4,0.0,608543.13,Important,vedika
203,204,10/01/2023,Toys,True,3697594935093,3241.9,0.0,605301.23,Non-important,vedika
204,205,10/01/2023,Books,True,3432982997703,3055.86,0.0,602245.37,Non-important,vedika
205,206,10/01/2023,Sports,True,3295537868130,583.27,0.0,601662.1,Non-important,vedika
206,207,10/01/2023,Shoes,False,3158782681594,0.0,59.85,601721.95,Important,vedika
207,208,10/01/2023,Grocery,True,3236900201022,1393.17,0.0,600328.78,Essential,vedika
208,209,10/01/2023,Books,True,3595535359081,2426.97,0.0,597901.81,Non-important,vedika
209,210,11/01/2023,Jewelry,True,3513899871688,4525.56,0.0,593376.25,Non-important,vedika
210,211,11/01/2023,Music,False,3087117743823,0.0,1272.62,594648.87,Essential,vedika
211,212,11/01/2023,Movies,True,3429418878999,4959.42,0.0,589689.45,Important,vedika
212,213,11/01/2023,Movies,True,3156502419105,2899.59,0.0,586789.86,Non-important,vedika
213,214,11/01/2023,Books,True,3221993473150,3665.74,0.0,583124.12,Non-Essential,vedika
214,215,11/01/2023,Sports,False,3478438649357,0.0,2864.33,585988.45,Essential,vedika
215,216,11/01/2023,Jewelry,False,3858761132834,0.0,7.2,585995.65,Non-important,vedika
216,217,11/01/2023,Electronics,False,3919378959243,0.0,2593.72,588589.37,Essential,vedika
217,218,11/01/2023,Electronics,True,3278330285125,3387.0,0.0,585202.37,Important,vedika
218,219,11/01/2023,Home,False,3445234240695,0.0,2632.36,587834.73,Essential,vedika
219,220,11/01/2023,Games,False,3116540959009,0.0,2384.14,590218.87,Non-Essential,vedika
220,221,11/01/2023,Industrial,True,3915564354445,317.93,0.0,589900.94,Essential,vedika
221,222,12/01/2023,Electronics,True,3650768210065,4993.89,0.0,584907.05,Non-Essential,vedika
222,223,12/01/2023,Books,True,3534823460140,2445.2,0.0,582461.85,Essential,vedika
223,224,12/01/2023,Music,False,3361794564682,0.0,2990.18,585452.03,Essential,vedika
224,225,12/01/2023,Automotive,False,3776761327817,0.0,813.25,586265.28,Essential,vedika
225,226,12/01/2023,Home,True,3610486843667,1731.65,0.0,584533.63,Non-Essential,vedika
226,227,12/01/2023,Kids,True,3620733590022,4110.27,0.0,580423.36,Non-Essential,vedika
227,228,12/01/2023,Kids,True,3028254195349,3206.16,0.0,577217.2,Essential,vedika
228,229,12/01/2023,Grocery,True,3636275991491,4803.23,0.0,572413.97,Essential,vedika
229,230,12/01/2023,Toys,False,3709613568135,0.0,20.28,572434.25,Non-important,vedika
230,231,12/01/2023,Kids,True,3434266619448,4895.61,0.0,567538.64,Essential,vedika
231,232,12/01/2023,Garden,False,3597956229781,0.0,35.79,567574.43,Essential,vedika
232,233,13/01/2023,Automotive,True,3200537889517,3256.9,0.0,564317.53,Essential,vedika
233,234,13/01/2023,Toys,False,3586951036308,0.0,1611.97,565929.5,Essential,vedika
234,235,13/01/2023,Outdoors,False,3433480287748,0.0,194.44,566123.94,Essential,vedika
235,236,13/01/2023,Computers,False,3779715105504,0.0,161.28,566285.22,Non-Essential,vedika
236,237,13/01/2023,Clothing,False,3202919923400,0.0,2026.14,568311.36,Non-important,vedika
237,238,13/01/2023,Kids,True,3136399544130,3004.94,0.0,565306.42,Essential,vedika
238,239,13/01/2023,Games,True,3607600160487,2699.57,0.0,562606.85,Essential,vedika
239,240,13/01/2023,Automotive,False,3933150106939,0.0,832.82,563439.67,Non-important,vedika
240,241,13/01/2023,Beauty,True,3073844279678,1417.46,0.0,562022.21,Important,vedika
241,242,14/01/2023,Music,True,3976682241065,927.75,0.0,561094.46,Non-Essential,vedika
242,243,14/01/2023,Kids,True,3751329061489,35.18,0.0,561059.28,Non-Essential,vedika
243,244,14/01/2023,Tools,False,3049570561902,0.0,1573.99,562633.27,Non-Essential,vedika
244,245,14/01/2023,Books,False,3311648787924,0.0,696.96,563330.23,Essential,vedika
245,246,14/01/2023,Kids,False,3978467483062,0.0,1686.97,565017.2,Non-Essential,vedika
246,247,14/01/2023,Grocery,False,3557166033124,0.0,2224.42,567241.62,Non-Essential,vedika
247,248,14/01/2023,Industrial,False,3557673819794,0.0,2816.88,570058.5,Non-important,vedika
248,249,14/01/2023,Movies,True,3624605737495,3658.48,0.0,566400.02,Essential,vedika
249,250,14/01/2023,Industrial,False,3571519607122,0.0,1402.41,567802.43,Non-Essential,vedika
250,251,14/01/2023,Beauty,False,3149624300556,0.0,435.32,568237.75,Important,vedika
251,252,14/01/2023,Garden,False,3184337340835,0.0,2604.22,570841.97,Non-important,vedika
252,253,14/01/2023,Kids,True,3348415246821,4324.78,0.0,566517.19,Non-Essential,vedika
253,254,15/01/2023,Baby,True,3412697166658,2127.41,0.0,564389.78,Non-Essential,vedika
254,255,15/01/2023,Health,False,3804387186852,0.0,2748.95,567138.73,Essential,vedika
255,256,15/01/2023,Music,True,3875430876882,4339.26,0.0,562799.47,Important,vedika
256,257,15/01/2023,Health,False,3622952726268,0.0,2781.28,565580.75,Essential,vedika
257,258,15/01/2023,Books,True,3787492522892,4405.82,0.0,561174.93,Non-Essential,vedika
258,259,15/01/2023,Jewelry,True,3616574385633,1076.45,0.0,560098.48,Non-Essential,vedika
259,260,15/01/2023,Industrial,False,3246017883897,0.0,2461.48,562559.96,Non-important,vedika
260,261,15/01/2023,Outdoors,False,3043562993308,0.0,2415.28,564975.24,Important,vedika
261,262,15/01/2023,Shoes,False,3612234215251,0.0,2141.05,567116.29,Non-important,vedika
262,263,15/01/2023,Electronics,False,3901701474150,0.0,2608.34,569724.63,Important,vedika
263,264,15/01/2023,Home,True,3757851408644,1396.92,0.0,568327.71,Non-Essential,vedika
264,265,15/01/2023,Movies,True,3639881292929,4773.41,0.0,563554.3,Non-important,vedika
265,266,15/01/2023,Games,False,3267419547271,0.0,430.56,563984.86,Essential,vedika
266,267,16/01/2023,Movies,True,3165473727403,3474.41,0.0,560510.45,Essential,vedika
267,268,16/01/2023,Movies,False,3377054863260,0.0,442.32,560952.77,Important,vedika
268,269,16/01/2023,Clothing,True,3380665293457,4187.57,0.0,556765.2,Non-Essential,vedika
269,270,16/01/2023,Shoes,False,3177232070876,0.0,52.29,556817.49,Non-Essential,vedika
270,271,16/01/2023,Garden,True,3676410052247,3371.04,0.0,553446.45,Non-Essential,vedika
271,272,16/01/2023,Sports,True,3855733434544,1877.9,0.0,551568.55,Non-important,vedika
272,273,16/01/2023,Tools,False,3416389760982,0.0,1399.23,552967.78,Important,vedika
273,274,16/01/2023,Shoes,True,3205845370277,2896.07,0.0,550071.71,Non-important,vedika
274,275,16/01/2023,Games,False,3343511170036,0.0,417.2,550488.91,Essential,vedika
275,276,17/01/2023,Health,True,3846917428098,889.14,0.0,549599.77,Important,vedika
276,277,17/01/2023,Movies,False,3914035448647,0.0,2121.72,551721.49,Non-Essential,vedika
277,278,17/01/2023,Home,True,3392850683762,221.08,0.0,551500.41,Non-Essential,vedika
278,279,17/01/2023,Clothing,True,3036672994336,722.53,0.0,550777.88,Non-important,vedika
279,280,17/01/2023,Movies,False,3983829428997,0.0,960.49,551738.37,Important,vedika
280,281,17/01/2023,Shoes,True,3376807817240,3351.33,0.0,548387.04,Important,vedika
281,282,17/01/2023,Movies,True,3783530088153,1317.43,0.0,547069.61,Essential,vedika
282,283,18/01/2023,Baby,True,3767312519727,1919.63,0.0,545149.98,Non-important,vedika
283,284,18/01/2023,Tools,False,3959283840896,0.0,2419.97,547569.95,Non-important,vedika
284,285,18/01/2023,Electronics,True,3797746378397,4631.59,0.0,542938.36,Non-Essential,vedika
285,286,18/01/2023,Garden,True,3585652241612,4150.57,0.0,538787.79,Non-important,vedika
286,287,18/01/2023,Tools,True,3771887263984,2052.16,0.0,536735.63,Important,vedika
287,288,18/01/2023,Computers,False,3913528720623,0.0,2217.58,538953.21,Non-important,vedika
288,289,18/01/2023,Jewelry,False,3501162341598,0.0,557.9,539511.11,Non-important,vedika
289,290,18/01/2023,Toys,True,3792427928202,4313.0,0.0,535198.11,Non-Essential,vedika
290,291,18/01/2023,Games,True,3479327434300,3829.89,0.0,531368.22,Non-Essential,vedika
291,292,18/01/2023,Home,True,3189988721883,749.43,0.0,530618.79,Important,vedika
292,293,18/01/2023,Grocery,False,3991691621741,0.0,1877.53,532496.32,Important,vedika
293,294,18/01/2023,Industrial,False,3713105397228,0.0,2577.7,535074.02,Non-important,vedika
294,295,18/01/2023,Sports,True,3984294920610,4522.61,0.0,530551.41,Non-important,vedika
295,296,18/01/2023,Tools,True,3627140918404,1516.33,0.0,529035.08,Non-important,vedika
296,297,18/01/2023,Garden,True,3428771848603,4216.57,0.0,524818.51,Non-important,vedika
297,298,18/01/2023,Kids,True,3843499442682,686.44,0.0,524132.07,Non-important,vedika
298,299,19/01/2023,Shoes,False,3532431677634,0.0,427.23,524559.3,Essential,vedika
299,300,19/01/2023,Grocery,True,3677258851066,4283.31,0.0,520275.99,Non-important,vedika
300,301,19/01/2023,Health,True,3932497092034,3075.72,0.0,517200.27,Important,vedika
301,302,19/01/2023,Grocery,True,3441910304522,3986.78,0.0,513213.49,Non-Essential,vedika
302,303,19/01/2023,Music,True,3657881856923,1264.48,0.0,511949.01,Essential,vedika
303,304,19/01/2023,Games,False,3529159372225,0.0,1054.47,513003.48,Essential,vedika
304,305,20/01/2023,Kids,False,3005345531757,0.0,862.15,513865.63,Essential,vedika
305,306,20/01/2023,Toys,True,3382616841311,2968.07,0.0,510897.56,Essential,vedika
306,307,20/01/2023,Jewelry,False,3346559432434,0.0,1833.91,512731.47,Non-Essential,vedika
307,308,20/01/2023,Grocery,True,3458990007994,4736.69,0.0,507994.78,Non-important,vedika
308,309,20/01/2023,Sports,False,3995318608382,0.0,185.08,508179.86,Essential,vedika
309,310,20/01/2023,Toys,False,3519231791075,0.0,476.2,508656.06,Important,vedika
310,311,20/01/2023,Home,True,3174790627387,3018.15,0.0,505637.91,Essential,vedika
311,312,20/01/2023,Computers,False,3656879395423,0.0,2881.65,508519.56,Essential,vedika
312,313,20/01/2023,Industrial,False,3473027948101,0.0,2439.9,510959.46,Non-Essential,vedika
313,314,21/01/2023,Books,True,3325312290954,3933.09,0.0,507026.37,Non-Essential,vedika
314,315,21/01/2023,Movies,True,3469925079478,191.22,0.0,506835.15,Essential,vedika
315,316,21/01/2023,Baby,False,3554335600452,0.0,2424.55,509259.7,Essential,vedika
316,317,21/01/2023,Music,True,3687241455755,1960.17,0.0,507299.53,Important,vedika
317,318,21/01/2023,Kids,True,3689076881079,2195.76,0.0,505103.77,Essential,vedika
318,319,21/01/2023,Kids,True,3975317038121,2181.82,0.0,502921.95,Essential,vedika
319,320,21/01/2023,Computers,True,3957581308263,1028.1,0.0,501893.85,Non-Essential,vedika
320,321,21/01/2023,Sports,False,3272505317568,0.0,2014.03,503907.88,Important,vedika
321,322,21/01/2023,Baby,True,3869384013244,2190.25,0.0,501717.63,Essential,vedika
322,323,21/01/2023,Movies,False,3385328603689,0.0,406.26,502123.89,Important,vedika
323,324,22/01/2023,Health,True,3413212229567,4282.93,0.0,497840.96,Non-Essential,vedika
324,325,22/01/2023,Shoes,False,3387800924944,0.0,1624.78,499465.74,Important,vedika
325,326,22/01/2023,Baby,False,3456543348774,0.0,1925.48,501391.22,Non-Essential,vedika
326,327,22/01/2023,Shoes,False,3664158073626,0.0,1387.44,502778.66,Non-Essential,vedika
327,328,22/01/2023,Sports,False,3811429988972,0.0,2805.1,505583.76,Non-important,vedika
328,329,22/01/2023,Books,False,3589775698230,0.0,1908.95,507492.71,Important,vedika
329,330,22/01/2023,Computers,True,3346936248567,536.26,0.0,506956.45,Essential,vedika
330,331,22/01/2023,Clothing,True,3708397898845,1018.82,0.0,505937.63,Important,vedika
331,332,22/01/2023,Jewelry,False,3403621075037,0.0,1594.91,507532.54,Non-important,vedika
332,333,22/01/2023,Home,True,3107021319411,1320.56,0.0,506211.98,Non-important,vedika
333,334,23/01/2023,Industrial,False,3873723049204,0.0,1257.37,507469.35,Important,vedika
334,335,23/01/2023,Electronics,True,3190028254348,422.56,0.0,507046.79,Essential,vedika
335,336,23/01/2023,Baby,False,3715197852521,0.0,1431.9,508478.69,Important,vedika
336,337,23/01/2023,Jewelry,False,3463937812412,0.0,1321.52,509800.21,Non-important,vedika
337,338,23/01/2023,Computers,False,3355121082568,0.0,390.02,510190.23,Non-important,vedika
338,339,23/01/2023,Baby,True,3154215151144,2104.51,0.0,508085.72,Non-important,vedika
339,340,23/01/2023,Home,False,3890624544467,0.0,1659.24,509744.96,Essential,vedika
340,341,23/01/2023,Shoes,False,3443593749404,0.0,1268.83,511013.79,Non-Essential,vedika
341,342,23/01/2023,Health,True,3542015435024,2918.19,0.0,508095.6,Important,vedika
342,343,23/01/2023,Music,True,3695992782612,3739.69,0.0,504355.91,Non-important,vedika
343,344,24/01/2023,Computers,True,3600529507047,451.17,0.0,503904.74,Important,vedika
344,345,24/01/2023,Jewelry,False,3460396193281,0.0,680.38,504585.12,Non-important,vedika
345,346,24/01/2023,Industrial,True,3352039132553,2188.24,0.0,502396.88,Important,vedika
346,347,24/01/2023,Games,False,3135190555273,0.0,261.04,502657.92,Non-important,vedika
347,348,24/01/2023,Tools,True,3065242360568,1027.68,0.0,501630.24,Important,vedika
348,349,24/01/2023,Clothing,True,3471761993415,1202.29,0.0,500427.95,Non-Essential,vedika
349,350,24/01/2023,Computers,False,3590247587771,0.0,2662.32,503090.27,Non-Essential,vedika
350,351,24/01/2023,Baby,False,3088168095372,0.0,2853.81,505944.08,Essential,vedika
351,352,24/01/2023,Beauty,False,3248842972427,0.0,1745.84,507689.92,Non-Essential,vedika
352,353,25/01/2023,Garden,False,3973597299336,0.0,1630.09,509320.01,Important,vedika
353,354,25/01/2023,Baby,True,3847315766153,4262.37,0.0,505057.64,Essential,vedika
354,355,25/01/2023,Home,False,3205821847217,0.0,1410.17,506467.81,Non-important,vedika
355,356,25/01/2023,Shoes,False,3388760411072,0.0,1255.13,507722.94,Essential,vedika
356,357,25/01/2023,Sports,False,3314093309246,0.0,1600.15,509323.09,Non-Essential,vedika
357,358,25/01/2023,Movies,False,3216406595303,0.0,1951.27,511274.36,Important,vedika
358,359,25/01/2023,Clothing,False,3841032324466,0.0,107.22,511381.58,Important,vedika
359,360,25/01/2023,Computers,True,3884424222058,2543.53,0.0,508838.05,Essential,vedika
360,361,25/01/2023,Movies,False,3856620732042,0.0,1987.01,510825.06,Non-Essential,vedika
361,362,25/01/2023,Shoes,True,3109464112562,2687.31,0.0,508137.75,Non-Essential,vedika
362,363,26/01/2023,Industrial,False,3950434842013,0.0,1509.96,509647.71,Non-Essential,vedika
363,364,26/01/2023,Grocery,True,3080924790997,4857.39,0.0,504790.32,Important,vedika
364,365,26/01/2023,Outdoors,True,3041912290411,1087.11,0.0,503703.21,Important,vedika
365,366,26/01/2023,Kids,False,3409029273973,0.0,371.68,504074.89,Non-Essential,vedika
366,367,26/01/2023,Home,True,3565485589437,3962.9,0.0,500111.99,Essential,vedika
367,368,26/01/2023,Tools,False,3382052598623,0.0,277.96,500389.95,Important,vedika
368,369,26/01/2023,Home,True,3603183067662,4598.03,0.0,495791.92,Non-Essential,vedika
369,370,26/01/2023,Home,False,3041207821118,0.0,980.71,496772.63,Non-important,vedika
370,371,26/01/2023,Beauty,True,3287559291442,222.29,0.0,496550.34,Non-important,vedika
371,372,26/01/2023,Baby,True,3172359317633,153.45,0.0,496396.89,Important,vedika
372,373,26/01/2023,Movies,True,3318810498019,3419.75,0.0,492977.14,Essential,vedika
373,374,26/01/2023,Games,False,3171368900859,0.0,221.57,493198.71,Important,vedika
374,375,26/01/2023,Garden,True,3716558943925,3488.52,0.0,489710.19,Essential,vedika
375,376,27/01/2023,Movies,True,3962235995819,855.46,0.0,488854.73,Non-Essential,vedika
376,377,27/01/2023,Movies,True,3989613140247,1271.55,0.0,487583.18,Important,vedika
377,378,27/01/2023,Books,False,3526549746838,0.0,2338.68,489921.86,Important,vedika
378,379,27/01/2023,Tools,True,3836212417020,3602.58,0.0,486319.28,Non-Essential,vedika
379,380,27/01/2023,Industrial,False,3408882075345,0.0,2259.11,488578.39,Important,vedika
380,381,27/01/2023,Tools,False,3822401324750,0.0,543.17,489121.56,Essential,vedika
381,382,27/01/2023,Jewelry,False,3182837528137,0.0,2793.35,491914.91,Non-important,vedika
382,383,27/01/2023,Grocery,True,3501610364813,4711.2,0.0,487203.71,Non-important,vedika
383,384,27/01/2023,Clothing,False,3766344639497,0.0,2093.93,489297.64,Important,vedika
384,385,27/01/2023,Beauty,False,3261162994242,0.0,265.04,489562.68,Non-Essential,vedika
385,386,27/01/2023,Toys,False,3031859403699,0.0,2104.38,491667.06,Non-Essential,vedika
386,387,28/01/2023,Automotive,False,3359589277716,0.0,90.38,491757.44,Essential,vedika
387,388,28/01/2023,Electronics,True,3944476476829,4302.73,0.0,487454.71,Non-important,vedika
388,389,28/01/2023,Kids,False,3456102883050,0.0,1095.25,488549.96,Important,vedika
389,390,28/01/2023,Electronics,True,3555441828251,3174.45,0.0,485375.51,Important,vedika
390,391,28/01/2023,Tools,True,3636405035659,671.85,0.0,484703.66,Important,vedika
391,392,28/01/2023,Clothing,False,3618580024844,0.0,140.48,484844.14,Essential,vedika
392,393,28/01/2023,Games,False,3287668803864,0.0,1579.72,486423.86,Non-important,vedika
393,394,28/01/2023,Books,False,3319594500297,0.0,668.57,487092.43,Important,vedika
394,395,29/01/2023,Tools,False,3247899844834,0.0,2410.5,489502.93,Non-Essential,vedika
395,396,29/01/2023,Computers,False,3779912537178,0.0,914.44,490417.37,Essential,vedika
396,397,29/01/2023,Shoes,True,3369724344001,3825.21,0.0,486592.16,Important,vedika
397,398,29/01/2023,Electronics,False,3940463595719,0.0,1594.38,488186.54,Essential,vedika
398,399,29/01/2023,Sports,False,3950569708201,0.0,2794.11,490980.65,Non-important,vedika
399,400,29/01/2023,Automotive,True,3932447591459,4750.8,0.0,486229.85,Non-Essential,vedika
400,401,30/01/2023,Kids,False,3571996260551,0.0,2681.84,488911.69,Non-important,vedika
401,402,30/01/2023,Baby,False,3122696816230,0.0,161.81,489073.5,Important,vedika
402,403,30/01/2023,Jewelry,True,3246115605715,3807.36,0.0,485266.14,Important,vedika
403,404,30/01/2023,Jewelry,True,3483839930582,2696.62,0.0,482569.52,Important,vedika
404,405,30/01/2023,Tools,True,3589831116528,1049.3,0.0,481520.22,Non-Essential,vedika
405,406,30/01/2023,Garden,False,3441686367840,0.0,180.38,481700.6,Non-Essential,vedika
406,407,30/01/2023,Industrial,True,3688263531133,2544.13,0.0,479156.47,Non-Essential,vedika
407,408,30/01/2023,Movies,True,3301912487545,4118.41,0.0,475038.06,Non-Essential,vedika
408,409,30/01/2023,Music,True,3910828220503,947.26,0.0,474090.8,Non-Essential,vedika
409,410,30/01/2023,Games,True,3683918103299,1784.77,0.0,472306.03,Non-important,vedika
410,411,30/01/2023,Industrial,False,3084468783270,0.0,274.19,472580.22,Non-important,vedika
411,412,30/01/2023,Home,False,3101350345083,0.0,617.17,473197.39,Non-important,vedika
412,413,30/01/2023,Movies,False,3194650902164,0.0,1334.25,474531.64,Non-important,vedika
413,414,31/01/2023,Outdoors,False,3334178620111,0.0,464.73,474996.37,Important,vedika
414,415,31/01/2023,Kids,True,3724858559626,3309.6,0.0,471686.77,Essential,vedika
415,416,31/01/2023,Shoes,False,3133779798942,0.0,219.27,471906.04,Essential,vedika
416,417,31/01/2023,Tools,True,3561023941406,2993.24,0.0,468912.8,Essential,vedika
417,418,31/01/2023,Outdoors,True,3580548152458,2032.43,0.0,466880.37,Non-Essential,vedika
418,419,31/01/2023,Garden,True,3236323595340,4441.32,0.0,462439.05,Non-Essential,vedika
419,420,31/01/2023,Sports,False,3955943114365,0.0,109.06,462548.11,Non-Essential,vedika
420,421,31/01/2023,Garden,False,3182586486156,0.0,157.61,462705.72,Non-Essential,vedika
421,422,31/01/2023,Sports,False,3025402052410,0.0,2364.69,465070.41,Non-important,vedika
422,423,31/01/2023,Clothing,False,3718122270101,0.0,2987.33,468057.74,Non-Essential,vedika
423,424,31/01/2023,Home,False,3939352043442,0.0,1295.19,469352.93,Non-important,vedika
424,425,01/02/2023,Music,False,3724165445240,0.0,2871.65,472224.58,Non-important,vedika
425,426,01/02/2023,Beauty,True,3627231253148,3843.36,0.0,468381.22,Important,vedika
426,427,01/02/2023,Music,False,3265694704272,0.0,2663.22,471044.44,Non-Essential,vedika
427,428,01/02/2023,Home,True,3363688215206,4781.64,0.0,466262.8,Non-Essential,vedika
428,429,01/02/2023,Electronics,False,3149501727334,0.0,812.1,467074.9,Non-important,vedika
429,430,01/02/2023,Grocery,False,3114379450307,0.0,431.15,467506.05,Non-important,vedika
430,431,01/02/2023,Jewelry,False,3808045515627,0.0,927.48,468433.53,Essential,vedika
431,432,01/02/2023,Sports,False,3296716455178,0.0,399.18,468832.71,Non-Essential,vedika
432,433,02/02/2023,Music,True,3511418136634,2376.0,0.0,466456.71,Non-Essential,vedika
433,434,02/02/2023,Sports,True,3809316161331,2315.56,0.0,464141.15,Important,vedika
434,435,02/02/2023,Home,False,3620618986289,0.0,607.22,464748.37,Non-important,vedika
435,436,02/02/2023,Books,True,3071211029502,1065.63,0.0,463682.74,Important,vedika
436,437,02/02/2023,Industrial,True,3071416257025,4022.05,0.0,459660.69,Non-important,vedika
437,438,02/02/2023,Music,True,3047105841305,824.88,0.0,458835.81,Non-Essential,vedika
438,439,02/02/2023,Garden,True,3190993974883,3066.95,0.0,455768.86,Essential,vedika
439,440,03/02/2023,Movies,False,3280251434911,0.0,2831.78,458600.64,Non-Essential,vedika
440,441,03/02/2023,Health,False,3954670847432,0.0,1215.58,459816.22,Essential,vedika
441,442,03/02/2023,Toys,True,3597490936516,4837.58,0.0,454978.64,Important,vedika
442,443,03/02/2023,Health,False,3878309927287,0.0,2439.57,457418.21,Essential,vedika
443,444,03/02/2023,Tools,False,3187709817774,0.0,1040.8,458459.01,Important,vedika
444,445,03/02/2023,Home,True,3960057066206,3000.55,0.0,455458.46,Important,vedika
445,446,03/02/2023,Kids,True,3785661858227,2247.21,0.0,453211.25,Important,vedika
446,447,03/02/2023,Outdoors,True,3309439249792,1144.63,0.0,452066.62,Important,vedika
447,448,03/02/2023,Jewelry,True,3993875141871,4407.13,0.0,447659.49,Important,vedika
448,449,04/02/2023,Movies,True,3022639909092,3104.9,0.0,444554.59,Non-important,vedika
449,450,04/02/2023,Toys,True,3708669216383,3318.8,0.0,441235.79,Important,vedika
450,451,04/02/2023,Kids,True,3483243350020,1744.78,0.0,439491.01,Non-important,vedika
451,452,04/02/2023,Grocery,True,3792963077068,2079.5,0.0,437411.51,Non-Essential,vedika
452,453,04/02/2023,Grocery,False,3533941354098,0.0,355.76,437767.27,Non-important,vedika
453,454,04/02/2023,Sports,True,3603561576461,1076.93,0.0,436690.34,Non-important,vedika
454,455,04/02/2023,Electronics,True,3900772877824,1000.36,0.0,435689.98,Non-Essential,vedika
455,456,04/02/2023,Tools,False,3539925733729,0.0,2883.71,438573.69,Essential,vedika
456,457,04/02/2023,Grocery,True,3254800576354,4375.35,0.0,434198.34,Important,vedika
457,458,05/02/2023,Movies,True,3522580535179,87.49,0.0,434110.85,Essential,vedika
458,459,05/02/2023,Books,False,3674844900930,0.0,1350.56,435461.41,Non-important,vedika
459,460,05/02/2023,Clothing,False,3108945993319,0.0,2890.12,438351.53,Essential,vedika
460,461,05/02/2023,Baby,True,3881226140042,871.64,0.0,437479.89,Essential,vedika
461,462,05/02/2023,Home,True,3226799998116,2930.73,0.0,434549.16,Essential,vedika
462,463,05/02/2023,Industrial,False,3545011763187,0.0,1112.13,435661.29,Non-important,vedika
463,464,05/02/2023,Music,False,3305860386836,0.0,1233.53,436894.82,Essential,vedika
464,465,05/02/2023,Automotive,True,3836343022296,56.41,0.0,436838.41,Non-important,vedika
465,466,05/02/2023,Automotive,True,3156926511737,4754.58,0.0,432083.83,Essential,vedika
466,467,05/02/2023,Kids,False,3251917973197,0.0,41.05,432124.88,Non-important,vedika
467,468,05/02/2023,Beauty,True,3095045655023,4800.15,0.0,427324.73,Essential,vedika
468,469,06/02/2023,Toys,True,3436746714336,3589.59,0.0,423735.14,Non-important,vedika
469,470,06/02/2023,Computers,False,3787816011228,0.0,1146.25,424881.39,Important,vedika
470,471,06/02/2023,Clothing,True,3734986237373,391.44,0.0,424489.95,Important,vedika
471,472,06/02/2023,Tools,True,3427454981515,3798.79,0.0,420691.16,Essential,vedika
472,473,06/02/2023,Grocery,False,3666367848115,0.0,1716.69,422407.85,Important,vedika
473,474,06/02/2023,Games,True,3445162553550,4658.39,0.0,417749.46,Essential,vedika
474,475,06/02/2023,Outdoors,True,3087861156544,3227.76,0.0,414521.7,Non-important,vedika
475,476,06/02/2023,Tools,True,3244750407726,1601.71,0.0,412919.99,Non-important,vedika
476,477,06/02/2023,Industrial,True,3283765060353,3191.27,0.0,409728.72,Non-important,vedika
477,478,06/02/2023,Baby,False,3332892366339,0.0,1610.67,411339.39,Non-Essential,vedika
478,479,06/02/2023,Sports,True,3230977102869,1513.16,0.0,409826.23,Non-Essential,vedika
479,480,06/02/2023,Baby,True,3622550316910,1657.94,0.0,408168.29,Non-Essential,vedika
480,481,06/02/2023,Garden,True,3021056535261,2328.6,0.0,405839.69,Non-Essential,vedika
481,482,06/02/2023,Health,False,3976630087452,0.0,1697.91,407537.6,Important,vedika
482,483,06/02/2023,Shoes,True,3278725099659,2767.34,0.0,404770.26,Non-important,vedika
483,484,07/02/2023,Tools,False,3494832918450,0.0,2491.01,407261.27,Non-important,vedika
484,485,07/02/2023,Home,True,3522598682259,2751.51,0.0,404509.76,Essential,vedika
485,486,07/02/2023,Automotive,False,3213617270074,0.0,1645.6,406155.36,Non-Essential,vedika
486,487,07/02/2023,Electronics,True,3956501876469,3287.78,0.0,402867.58,Essential,vedika
487,488,07/02/2023,Beauty,False,3700400666253,0.0,800.69,403668.27,Non-Essential,vedika
488,489,07/02/2023,Jewelry,False,3318252119102,0.0,1506.56,405174.83,Non-Essential,vedika
489,490,07/02/2023,Health,False,3139958723525,0.0,1292.54,406467.37,Important,vedika
490,491,07/02/2023,Movies,False,3197374159612,0.0,2524.18,408991.55,Important,vedika
491,492,07/02/2023,Movies,True,3864937735670,1198.93,0.0,407792.62,Essential,vedika
492,493,07/02/2023,Grocery,True,3722430142474,4266.0,0.0,403526.62,Non-important,vedika
493,494,07/02/2023,Home,True,3947919211470,11.99,0.0,403514.63,Important,vedika
494,495,07/02/2023,Health,False,3058778817526,0.0,1272.32,404786.95,Non-important,vedika
495,496,08/02/2023,Industrial,True,3712735983480,4124.32,0.0,400662.63,Important,vedika
496,497,08/02/2023,Industrial,False,3377702594762,0.0,2099.54,402762.17,Non-Essential,vedika
497,498,08/02/2023,Automotive,True,3915166480256,2329.24,0.0,400432.93,Important,vedika
498,499,08/02/2023,Home,False,3715646944156,0.0,2595.63,403028.56,Non-important,vedika
499,500,08/02/2023,Music,False,3101229347978,0.0,690.89,403719.45,Non-important,vedika
500,501,08/02/2023,Grocery,False,3818805181839,0.0,210.57,403930.02,Non-important,vedika
501,502,08/02/2023,Outdoors,True,3461557877278,189.11,0.0,403740.91,Non-Essential,vedika
502,503,08/02/2023,Games,False,3965783217786,0.0,235.03,403975.94,Essential,vedika
503,504,08/02/2023,Grocery,False,3720503236624,0.0,2229.96,406205.9,Important,vedika
504,505,08/02/2023,Sports,True,3010815975424,4827.09,0.0,401378.81,Essential,vedika
505,506,09/02/2023,Books,True,3317266071671,4587.87,0.0,396790.94,Non-Essential,vedika
506,507,09/02/2023,Home,False,3380773431656,0.0,890.93,397681.87,Non-Essential,vedika
507,508,09/02/2023,Sports,False,3977615116914,0.0,1756.55,399438.42,Essential,vedika
508,509,09/02/2023,Beauty,True,3493341060832,1252.1,0.0,398186.32,Essential,vedika
509,510,09/02/2023,Books,True,3131071972139,4825.5,0.0,393360.82,Non-Essential,vedika
510,511,09/02/2023,Beauty,False,3848828010915,0.0,329.86,393690.68,Non-important,vedika
511,512,09/02/2023,Movies,False,3462832170750,0.0,310.13,394000.81,Important,vedika
512,513,09/02/2023,Tools,False,3856238929967,0.0,99.13,394099.94,Non-important,vedika
513,514,09/02/2023,Games,True,3788204906574,646.65,0.0,393453.29,Non-Essential,vedika
514,515,09/02/2023,Shoes,True,3200398805519,2000.25,0.0,391453.04,Important,vedika
515,516,09/02/2023,Music,False,3074462422048,0.0,2550.51,394003.55,Essential,vedika
516,517,09/02/2023,Clothing,True,3379302441153,3085.75,0.0,390917.8,Non-Essential,vedika
517,518,09/02/2023,Sports,False,3113245678141,0.0,623.45,391541.25,Non-important,vedika
518,519,10/02/2023,Electronics,True,3310478580253,3503.2,0.0,388038.05,Essential,vedika
519,520,10/02/2023,Kids,False,3682399518045,0.0,1763.56,389801.61,Essential,vedika
520,521,10/02/2023,Books,True,3859339593737,4965.73,0.0,384835.88,Essential,vedika
521,522,10/02/2023,Games,True,3396133977479,1995.8,0.0,382840.08,Essential,vedika
522,523,10/02/2023,Tools,True,3999384978986,1425.07,0.0,381415.01,Important,vedika
523,524,10/02/2023,Jewelry,True,3100423578132,4437.77,0.0,376977.24,Non-Essential,vedika
524,525,10/02/2023,Kids,True,3194231840338,904.06,0.0,376073.18,Essential,vedika
525,526,10/02/2023,Toys,True,3484449288072,4841.67,0.0,371231.51,Important,vedika
526,527,11/02/2023,Clothing,True,3176820721820,3168.01,0.0,368063.5,Important,vedika
527,528,11/02/2023,Home,False,3592257492359,0.0,2503.12,370566.62,Non-Essential,vedika
528,529,11/02/2023,Kids,True,3803248237130,3310.17,0.0,367256.45,Non-important,vedika
529,530,11/02/2023,Baby,False,3467729473191,0.0,696.23,367952.68,Important,vedika
530,531,11/02/2023,Kids,False,3884100095013,0.0,2838.96,370791.64,Important,vedika
531,532,11/02/2023,Health,False,3980718078825,0.0,1756.95,372548.59,Essential,vedika
532,533,11/02/2023,Shoes,False,3543108545906,0.0,2034.58,374583.17,Non-important,vedika
533,534,11/02/2023,Industrial,False,3243356559340,0.0,1795.49,376378.66,Important,vedika
534,535,12/02/2023,Jewelry,False,3682430832943,0.0,1074.74,377453.4,Important,vedika
535,536,12/02/2023,Outdoors,True,3572830348325,4528.5,0.0,372924.9,Essential,vedika
536,537,12/02/2023,Home,True,3048785656415,3107.42,0.0,369817.48,Important,vedika
537,538,12/02/2023,Music,False,3142502187213,0.0,37.35,369854.83,Non-important,vedika
538,539,12/02/2023,Toys,False,3532329202726,0.0,1633.04,371487.87,Important,vedika
539,540,12/02/2023,Garden,True,3006428162320,197.81,0.0,371290.06,Non-important,vedika
540,541,12/02/2023,Beauty,True,3065297237083,3666.02,0.0,367624.04,Important,vedika
541,542,12/02/2023,Clothing,False,3473345053178,0.0,2633.68,370257.72,Essential,vedika
542,543,12/02/2023,Toys,True,3465830359059,744.48,0.0,369513.24,Important,vedika
543,544,12/02/2023,Toys,True,3486536099814,3972.62,0.0,365540.62,Essential,vedika
544,545,12/02/2023,Movies,False,3900780542615,0.0,2412.37,367952.99,Essential,vedika
545,546,13/02/2023,Computers,True,3450369967795,1416.55,0.0,366536.44,Important,vedika
546,547,13/02/2023,Computers,False,3069473069809,0.0,2881.56,369418.0,Non-Essential,vedika
547,548,13/02/2023,Grocery,False,3758364195854,0.0,493.24,369911.24,Non-important,vedika
548,549,13/02/2023,Music,True,3558793933058,1689.92,0.0,368221.32,Essential,vedika
549,550,13/02/2023,Outdoors,True,3008042692821,3689.9,0.0,364531.42,Important,vedika
550,551,13/02/2023,Games,True,3818350951817,4005.45,0.0,360525.97,Non-important,vedika
551,552,13/02/2023,Shoes,True,3379895457443,2196.09,0.0,358329.88,Non-Essential,vedika
552,553,13/02/2023,Movies,True,3493612640333,3682.13,0.0,354647.75,Essential,vedika
553,554,13/02/2023,Baby,False,3218605344034,0.0,2912.42,357560.17,Non-important,vedika
554,555,14/02/2023,Baby,False,3579754299121,0.0,2761.53,360321.7,Non-important,vedika
555,556,14/02/2023,Music,False,3488089789643,0.0,2201.99,362523.69,Essential,vedika
556,557,14/02/2023,Games,True,3053315869834,1323.46,0.0,361200.23,Non-important,vedika
557,558,14/02/2023,Jewelry,True,3157253920612,3395.01,0.0,357805.22,Non-Essential,vedika
558,559,14/02/2023,Garden,True,3565566966805,4540.66,0.0,353264.56,Essential,vedika
559,560,14/02/2023,Games,False,3438730135310,0.0,2095.5,355360.06,Important,vedika
560,561,14/02/2023,Music,True,3557911616975,3389.7,0.0,351970.36,Essential,vedika
561,562,14/02/2023,Shoes,True,3826098129227,3466.73,0.0,348503.63,Non-important,vedika
562,563,14/02/2023,Tools,False,3685109822644,0.0,19.95,348523.58,Important,vedika
563,564,15/02/2023,Health,True,3479835311827,4640.39,0.0,343883.19,Important,vedika
564,565,15/02/2023,Jewelry,False,3341369088426,0.0,2420.14,346303.33,Non-Essential,vedika
565,566,15/02/2023,Music,False,3758596414302,0.0,2176.13,348479.46,Important,vedika
566,567,15/02/2023,Kids,False,3014736216199,0.0,2741.58,351221.04,Essential,vedika
567,568,15/02/2023,Industrial,True,3513675890224,3300.45,0.0,347920.59,Important,vedika
568,569,15/02/2023,Clothing,False,3322865853650,0.0,426.77,348347.36,Important,vedika
569,570,15/02/2023,Garden,False,3973973998826,0.0,121.36,348468.72,Essential,vedika
570,571,15/02/2023,Garden,True,3825119688959,884.03,0.0,347584.69,Non-important,vedika
571,572,15/02/2023,Games,False,3145834824145,0.0,2317.33,349902.02,Essential,vedika
572,573,15/02/2023,Kids,True,3579345082588,348.74,0.0,349553.28,Essential,vedika
573,574,15/02/2023,Health,True,3977705040949,2830.12,0.0,346723.16,Essential,vedika
574,575,15/02/2023,Shoes,False,3119575107196,0.0,2461.91,349185.07,Non-important,vedika
575,576,15/02/2023,Music,False,3897474983236,0.0,2960.82,352145.89,Non-Essential,vedika
576,577,15/02/2023,Music,False,3364941035172,0.0,1423.62,353569.51,Non-Essential,vedika
577,578,15/02/2023,Games,True,3365579051847,4658.8,0.0,348910.71,Non-Essential,vedika
578,579,15/02/2023,Health,True,3647295755987,568.76,0.0,348341.95,Non-important,vedika
579,580,16/02/2023,Beauty,False,3704762027871,0.0,2401.06,350743.01,Non-Essential,vedika
580,581,16/02/2023,Automotive,False,3424982128555,0.0,4.11,350747.12,Non-Essential,vedika
581,582,16/02/2023,Toys,True,3046745253345,1342.88,0.0,349404.24,Non-important,vedika
582,583,16/02/2023,Music,True,3759182432947,2481.26,0.0,346922.98,Important,vedika
583,584,16/02/2023,Tools,False,3540744664408,0.0,1509.65,348432.63,Important,vedika
584,585,16/02/2023,Health,False,3777260092996,0.0,1290.96,349723.59,Important,vedika
585,586,16/02/2023,Clothing,False,3366642005768,0.0,593.1,350316.69,Non-Essential,vedika
586,587,16/02/2023,Garden,False,3894890743769,0.0,1349.73,351666.42,Essential,vedika
587,588,16/02/2023,Baby,False,3188051670730,0.0,865.2,352531.62,Important,vedika
588,589,16/02/2023,Home,True,3021713080438,494.46,0.0,352037.16,Important,vedika
589,590,16/02/2023,Outdoors,False,3077950083782,0.0,329.34,352366.5,Non-important,vedika
590,591,16/02/2023,Books,False,3582897778163,0.0,2346.12,354712.62,Non-important,vedika
591,592,16/02/2023,Electronics,True,3732486751847,1830.12,0.0,352882.5,Non-important,vedika
592,593,16/02/2023,Movies,False,3633507507947,0.0,651.0,353533.5,Non-Essential,vedika
593,594,16/02/2023,Music,True,3743518991153,2204.9,0.0,351328.6,Non-important,vedika
594,595,16/02/2023,Movies,False,3019774468412,0.0,2999.78,354328.38,Non-Essential,vedika
595,596,17/02/2023,Health,False,3275772918655,0.0,2169.02,356497.4,Non-Essential,vedika
596,597,17/02/2023,Shoes,True,3741813921048,3538.14,0.0,352959.26,Non-important,vedika
597,598,17/02/2023,Sports,True,3513974100319,2358.27,0.0,350600.99,Important,vedika
598,599,17/02/2023,Clothing,False,3915559146068,0.0,683.66,351284.65,Non-important,vedika
599,600,17/02/2023,Beauty,False,3325565626326,0.0,643.99,351928.64,Essential,vedika
600,601,17/02/2023,Jewelry,False,3624347370576,0.0,1769.44,353698.08,Important,vedika
601,602,17/02/2023,Health,True,3657331286152,2655.12,0.0,351042.96,Essential,vedika
602,603,17/02/2023,Clothing,False,3839938615897,0.0,483.85,351526.81,Essential,vedika
603,604,17/02/2023,Music,True,3986840786536,2972.45,0.0,348554.36,Non-Essential,vedika
604,605,18/02/2023,Beauty,True,3074178686189,3564.53,0.0,344989.83,Non-Essential,vedika
605,606,18/02/2023,Computers,True,3924879869837,761.92,0.0,344227.91,Non-Essential,vedika
606,607,18/02/2023,Industrial,True,3688103601374,1040.32,0.0,343187.59,Important,vedika
607,608,18/02/2023,Health,False,3752041604732,0.0,995.72,344183.31,Non-important,vedika
608,609,18/02/2023,Baby,False,3080156919591,0.0,1792.63,345975.94,Essential,vedika
609,610,18/02/2023,Books,False,3012675712876,0.0,2040.6,348016.54,Non-Essential,vedika
610,611,18/02/2023,Outdoors,True,3092928904225,3278.01,0.0,344738.53,Non-Essential,vedika
611,612,18/02/2023,Baby,False,3538207200988,0.0,324.64,345063.17,Non-important,vedika
612,613,18/02/2023,Clothing,False,3147490464493,0.0,2251.94,347315.11,Important,vedika
613,614,19/02/2023,Home,False,3347611863669,0.0,524.86,347839.97,Non-important,vedika
614,615,19/02/2023,Books,True,3308862502811,4684.94,0.0,343155.03,Essential,vedika
615,616,19/02/2023,Sports,True,3745643074149,3637.5,0.0,339517.53,Non-important,vedika
616,617,19/02/2023,Industrial,True,3814423024073,2256.69,0.0,337260.84,Non-Essential,vedika
617,618,19/02/2023,Books,False,3386303492329,0.0,1809.88,339070.72,Important,vedika
618,619,19/02/2023,Computers,False,3829425558133,0.0,2773.27,341843.99,Important,vedika
619,620,19/02/2023,Grocery,True,3175725865441,1355.47,0.0,340488.52,Important,vedika
620,621,19/02/2023,Shoes,False,3529941590406,0.0,2095.9,342584.42,Essential,vedika
621,622,19/02/2023,Jewelry,True,3944081060802,1861.78,0.0,340722.64,Essential,vedika
622,623,19/02/2023,Baby,True,3356178103162,1572.86,0.0,339149.78,Non-Essential,vedika
623,624,19/02/2023,Baby,False,3682655208261,0.0,2025.94,341175.72,Important,vedika
624,625,19/02/2023,Automotive,False,3235576759519,0.0,1025.36,342201.08,Non-Essential,vedika
625,626,19/02/2023,Baby,False,3513594085585,0.0,1782.45,343983.53,Essential,vedika
626,627,19/02/2023,Clothing,False,3610852419522,0.0,392.71,344376.24,Non-important,vedika
627,628,19/02/2023,Kids,True,3105645609000,1181.93,0.0,343194.31,Essential,vedika
628,629,19/02/2023,Industrial,True,3055470452157,3280.22,0.0,339914.09,Important,vedika
629,630,19/02/2023,Automotive,False,3562302941206,0.0,2836.94,342751.03,Non-Essential,vedika
630,631,20/02/2023,Health,False,3547136282471,0.0,1114.95,343865.98,Non-Essential,vedika
631,632,20/02/2023,Industrial,False,3075855072547,0.0,2100.35,345966.33,Non-Essential,vedika
632,633,20/02/2023,Toys,False,3253793721669,0.0,1742.65,347708.98,Non-Essential,vedika
633,634,20/02/2023,Beauty,False,3466311994066,0.0,2133.3,349842.28,Important,vedika
634,635,20/02/2023,Clothing,True,3499642412100,816.39,0.0,349025.89,Essential,vedika
635,636,20/02/2023,Books,False,3017061260173,0.0,764.04,349789.93,Important,vedika
636,637,20/02/2023,Toys,False,3090696317119,0.0,2769.75,352559.68,Important,vedika
637,638,20/02/2023,Computers,False,3243907080020,0.0,737.58,353297.26,Essential,vedika
638,639,20/02/2023,Grocery,False,3006834202694,0.0,936.92,354234.18,Non-Essential,vedika
639,640,21/02/2023,Sports,True,3614890057618,1405.98,0.0,352828.2,Non-important,vedika
640,641,21/02/2023,Movies,False,3254900529422,0.0,2722.69,355550.89,Non-Essential,vedika
641,642,21/02/2023,Outdoors,False,3278536774072,0.0,664.8,356215.69,Important,vedika
642,643,21/02/2023,Clothing,True,3878027482166,4502.19,0.0,351713.5,Important,vedika
643,644,21/02/2023,Clothing,True,3311720386314,3425.57,0.0,348287.93,Important,vedika
644,645,21/02/2023,Books,False,3684839708486,0.0,1847.93,350135.86,Important,vedika
645,646,21/02/2023,Games,False,3312859065058,0.0,152.74,350288.6,Non-important,vedika
646,647,21/02/2023,Sports,False,3075396898876,0.0,554.56,350843.16,Essential,vedika
647,648,21/02/2023,Games,True,3820797190553,784.24,0.0,350058.92,Essential,vedika
648,649,21/02/2023,Electronics,False,3137095346586,0.0,2425.01,352483.93,Non-Essential,vedika
649,650,21/02/2023,Computers,True,3882600899894,555.71,0.0,351928.22,Non-important,vedika
650,651,21/02/2023,Industrial,True,3737098284177,1794.58,0.0,350133.64,Important,vedika
651,652,21/02/2023,Music,False,3554358842731,0.0,1130.12,351263.76,Important,vedika
652,653,21/02/2023,Music,False,3478734918598,0.0,909.15,352172.91,Non-Essential,vedika
653,654,22/02/2023,Electronics,True,3514354487922,2330.82,0.0,349842.09,Non-Essential,vedika
654,655,22/02/2023,Toys,False,3485954092266,0.0,2824.8,352666.89,Non-important,vedika
655,656,22/02/2023,Games,True,3728574150227,3722.71,0.0,348944.18,Essential,vedika
656,657,22/02/2023,Games,True,3066317109124,3926.55,0.0,345017.63,Non-important,vedika
657,658,22/02/2023,Jewelry,False,3651420266523,0.0,2941.79,347959.42,Essential,vedika
658,659,22/02/2023,Books,True,3280741681047,4523.03,0.0,343436.39,Non-Essential,vedika
659,660,22/02/2023,Computers,True,3541208624590,4219.86,0.0,339216.53,Important,vedika
660,661,22/02/2023,Books,False,3364765378857,0.0,649.74,339866.27,Important,vedika
661,662,22/02/2023,Sports,True,3440855131528,4012.41,0.0,335853.86,Non-important,vedika
662,663,22/02/2023,Tools,True,3673505439082,1943.56,0.0,333910.3,Essential,vedika
663,664,22/02/2023,Books,False,3967344275886,0.0,1973.54,335883.84,Essential,vedika
664,665,22/02/2023,Toys,True,3914675087440,2117.71,0.0,333766.13,Non-Essential,vedika
665,666,22/02/2023,Home,True,3975289837292,1364.04,0.0,332402.09,Non-important,vedika
666,667,23/02/2023,Outdoors,True,3486661219335,936.51,0.0,331465.58,Non-important,vedika
667,668,23/02/2023,Movies,False,3313765641170,0.0,204.71,331670.29,Non-important,vedika
668,669,23/02/2023,Home,True,3701077158957,3273.79,0.0,328396.5,Essential,vedika
669,670,23/02/2023,Books,False,3246471994574,0.0,1311.25,329707.75,Non-important,vedika
670,671,23/02/2023,Sports,True,3171340641952,2674.43,0.0,327033.32,Essential,vedika
671,672,23/02/2023,Sports,True,3750250773505,4401.12,0.0,322632.2,Important,vedika
672,673,23/02/2023,Health,True,3498844189330,1284.84,0.0,321347.36,Non-Essential,vedika
673,674,23/02/2023,Computers,True,3891638060094,654.01,0.0,320693.35,Non-Essential,vedika
674,675,23/02/2023,Clothing,False,3843554428686,0.0,1040.27,321733.62,Non-important,vedika
675,676,23/02/2023,Grocery,False,3834135797104,0.0,1124.1,322857.72,Essential,vedika
676,677,23/02/2023,Clothing,True,3942096317229,2055.44,0.0,320802.28,Important,vedika
677,678,23/02/2023,Beauty,True,3087412770557,1143.26,0.0,319659.02,Non-Essential,vedika
678,679,23/02/2023,Outdoors,False,3777168896904,0.0,2043.49,321702.51,Non-Essential,vedika
679,680,23/02/2023,Movies,True,3057305045419,3355.34,0.0,318347.17,Essential,vedika
680,681,23/02/2023,Automotive,True,3833268696704,332.47,0.0,318014.7,Important,vedika
681,682,23/02/2023,Kids,True,3465816865024,3409.26,0.0,314605.44,Essential,vedika
682,683,23/02/2023,Jewelry,False,3648139443075,0.0,2901.04,317506.48,Non-important,vedika
683,684,24/02/2023,Movies,True,3856547992924,611.12,0.0,316895.36,Non-Essential,vedika
684,685,24/02/2023,Home,True,3218343058276,4289.94,0.0,312605.42,Important,vedika
685,686,24/02/2023,Garden,True,3903016845152,4334.85,0.0,308270.57,Non-important,vedika
686,687,24/02/2023,Clothing,False,3685590013880,0.0,2084.14,310354.71,Non-important,vedika
687,688,24/02/2023,Baby,False,3152759593751,0.0,1322.55,311677.26,Essential,vedika
688,689,24/02/2023,Health,False,3860490397684,0.0,611.28,312288.54,Non-important,vedika
689,690,24/02/2023,Jewelry,False,3781932700681,0.0,998.3,313286.84,Non-important,vedika
690,691,25/02/2023,Home,False,3791159374177,0.0,2066.25,315353.09,Essential,vedika
691,692,25/02/2023,Toys,True,3070611122181,3115.97,0.0,312237.12,Essential,vedika
692,693,25/02/2023,Jewelry,True,3829032539975,1739.61,0.0,310497.51,Important,vedika
693,694,25/02/2023,Outdoors,True,3807906932512,4168.4,0.0,306329.11,Essential,vedika
694,695,25/02/2023,Jewelry,False,3584518104679,0.0,386.84,306715.95,Non-important,vedika
695,696,25/02/2023,Beauty,False,3176121379927,0.0,2806.6,309522.55,Non-Essential,vedika
696,697,25/02/2023,Tools,False,3762712262991,0.0,1244.85,310767.4,Important,vedika
697,698,25/02/2023,Health,True,3699209665633,3584.58,0.0,307182.82,Important,vedika
698,699,25/02/2023,Kids,False,3710818284804,0.0,811.12,307993.94,Essential,vedika
699,700,25/02/2023,Automotive,True,3120397905506,1534.9,0.0,306459.04,Essential,vedika
700,701,25/02/2023,Home,False,3236881843627,0.0,2800.3,309259.34,Non-Essential,vedika
701,702,25/02/2023,Industrial,True,3766509380682,3294.38,0.0,305964.96,Non-Essential,vedika
702,703,25/02/2023,Grocery,True,3053552579179,4363.22,0.0,301601.74,Important,vedika
703,704,25/02/2023,Outdoors,False,3172076513291,0.0,970.28,302572.02,Non-Essential,vedika
704,705,25/02/2023,Shoes,False,3958354778019,0.0,1537.88,304109.9,Non-Essential,vedika
705,706,25/02/2023,Outdoors,False,3360417585248,0.0,2384.83,306494.73,Essential,vedika
706,707,25/02/2023,Clothing,True,3341086888338,4542.9,0.0,301951.83,Non-Essential,vedika
707,708,25/02/2023,Games,True,3978146109543,897.86,0.0,301053.97,Important,vedika
708,709,25/02/2023,Sports,False,3790352258024,0.0,2875.36,303929.33,Essential,vedika
709,710,26/02/2023,Industrial,False,3033428108196,0.0,2566.84,306496.17,Essential,vedika
710,711,26/02/2023,Automotive,True,3310499263388,2915.88,0.0,303580.29,Important,vedika
711,712,26/02/2023,Clothing,True,3295443142687,4052.32,0.0,299527.97,Essential,vedika
712,713,26/02/2023,Garden,True,3449432490602,1903.16,0.0,297624.81,Non-important,vedika
713,714,26/02/2023,Outdoors,True,3377848437485,212.6,0.0,297412.21,Non-important,vedika
714,715,26/02/2023,Home,False,3325548417873,0.0,276.79,297689.0,Important,vedika
715,716,26/02/2023,Shoes,False,3672887032701,0.0,1895.92,299584.92,Non-important,vedika
716,717,26/02/2023,Sports,True,3058481157330,1782.11,0.0,297802.81,Essential,vedika
717,718,26/02/2023,Shoes,False,3049270925950,0.0,372.18,298174.99,Non-Essential,vedika
718,719,27/02/2023,Garden,False,3879818548104,0.0,2917.59,301092.58,Non-Essential,vedika
719,720,27/02/2023,Electronics,False,3983478901769,0.0,1006.83,302099.41,Non-important,vedika
720,721,27/02/2023,Industrial,False,3079277221713,0.0,1222.48,303321.89,Essential,vedika
721,722,27/02/2023,Kids,True,3148048366544,254.38,0.0,303067.51,Non-important,vedika
722,723,27/02/2023,Electronics,True,3539635214536,4584.37,0.0,298483.14,Important,vedika
723,724,27/02/2023,Jewelry,False,3561756416521,0.0,852.06,299335.2,Non-Essential,vedika
724,725,27/02/2023,Shoes,True,3974011479098,1343.45,0.0,297991.75,Essential,vedika
725,726,27/02/2023,Outdoors,True,3778040535884,2845.0,0.0,295146.75,Essential,vedika
726,727,28/02/2023,Tools,True,3961959467767,910.37,0.0,294236.38,Essential,vedika
727,728,28/02/2023,Movies,False,3741033600699,0.0,1769.8,296006.18,Important,vedika
728,729,28/02/2023,Toys,False,3383190526651,0.0,1922.97,297929.15,Non-important,vedika
729,730,28/02/2023,Automotive,True,3021455023542,4304.73,0.0,293624.42,Non-Essential,vedika
730,731,28/02/2023,Clothing,True,3772484755344,161.84,0.0,293462.58,Important,vedika
731,732,28/02/2023,Clothing,True,3033236152999,2945.76,0.0,290516.82,Non-important,vedika
732,733,28/02/2023,Baby,False,3505563419391,0.0,528.63,291045.45,Essential,vedika
733,734,28/02/2023,Industrial,False,3485567677254,0.0,440.44,291485.89,Non-important,vedika
734,735,28/02/2023,Music,True,3858245715508,3035.34,0.0,288450.55,Non-Essential,vedika
735,736,28/02/2023,Music,False,3789076915913,0.0,2156.12,290606.67,Non-important,vedika
736,737,28/02/2023,Home,False,3222143383344,0.0,1228.33,291835.0,Essential,vedika
737,738,01/03/2023,Electronics,False,3679864632801,0.0,864.9,292699.9,Essential,vedika
738,739,01/03/2023,Sports,False,3211901386274,0.0,1987.66,294687.56,Non-Essential,vedika
739,740,01/03/2023,Sports,False,3567778362764,0.0,1039.4,295726.96,Important,vedika
740,741,01/03/2023,Outdoors,True,3853442521525,4522.83,0.0,291204.13,Essential,vedika
741,742,01/03/2023,Electronics,False,3766499422001,0.0,1551.92,292756.05,Essential,vedika
742,743,01/03/2023,Toys,False,3147094482524,0.0,1310.75,294066.8,Non-important,vedika
743,744,01/03/2023,Electronics,True,3359530457554,2754.76,0.0,291312.04,Non-Essential,vedika
744,745,01/03/2023,Clothing,False,3602073932431,0.0,2435.59,293747.63,Essential,vedika
745,746,01/03/2023,Electronics,True,3841152699107,3852.99,0.0,289894.64,Non-important,vedika
746,747,01/03/2023,Computers,False,3116448384107,0.0,754.04,290648.68,Non-Essential,vedika
747,748,01/03/2023,Books,True,3884228255070,1591.88,0.0,289056.8,Non-important,vedika
748,749,01/03/2023,Movies,True,3162096354322,2145.59,0.0,286911.21,Non-important,vedika
749,750,01/03/2023,Home,False,3410305819437,0.0,762.58,287673.79,Non-important,vedika
750,751,01/03/2023,Games,False,3494988533831,0.0,1608.98,289282.77,Essential,vedika
751,752,01/03/2023,Shoes,False,3237284383711,0.0,1815.69,291098.46,Non-Essential,vedika
752,753,01/03/2023,Music,True,3941930172187,1193.93,0.0,289904.53,Non-important,vedika
753,754,01/03/2023,Outdoors,False,3685112756120,0.0,2258.31,292162.84,Non-important,vedika
754,755,01/03/2023,Computers,False,3599439816817,0.0,1585.9,293748.74,Essential,vedika
755,756,01/03/2023,Home,True,3878165134810,11.3,0.0,293737.44,Non-Essential,vedika
756,757,02/03/2023,Garden,True,3562105237092,4123.86,0.0,289613.58,Non-important,vedika
757,758,02/03/2023,Games,True,3567768069784,3486.13,0.0,286127.45,Important,vedika
758,759,02/03/2023,Books,True,3970956082592,4545.93,0.0,281581.52,Non-Essential,vedika
759,760,02/03/2023,Tools,False,3497235655679,0.0,779.86,282361.38,Non-Essential,vedika
760,761,02/03/2023,Health,True,3547488543115,3070.41,0.0,279290.97,Essential,vedika
761,762,02/03/2023,Tools,True,3968479731390,3477.57,0.0,275813.4,Non-important,vedika
762,763,02/03/2023,Toys,False,3786022983646,0.0,380.19,276193.59,Important,vedika
763,764,02/03/2023,Clothing,True,3403683101553,4998.87,0.0,271194.72,Essential,vedika
764,765,02/03/2023,Beauty,False,3443478601804,0.0,82.48,271277.2,Non-Essential,vedika
765,766,02/03/2023,Toys,False,3000845429553,0.0,925.27,272202.47,Essential,vedika
766,767,02/03/2023,Grocery,False,3955968485508,0.0,655.39,272857.86,Essential,vedika
767,768,02/03/2023,Garden,True,3960300787968,104.94,0.0,272752.92,Non-important,vedika
768,769,02/03/2023,Baby,False,3291910870604,0.0,2524.42,275277.34,Important,vedika
769,770,02/03/2023,Computers,True,3487491524071,4098.81,0.0,271178.53,Non-Essential,vedika
770,771,02/03/2023,Jewelry,True,3740048261446,2116.88,0.0,269061.65,Non-important,vedika
771,772,03/03/2023,Outdoors,False,3347049841352,0.0,139.21,269200.86,Non-Essential,vedika
772,773,03/03/2023,Jewelry,False,3565170068585,0.0,1151.81,270352.67,Non-important,vedika
773,774,03/03/2023,Kids,True,3320933637632,3800.71,0.0,266551.96,Essential,vedika
774,775,03/03/2023,Movies,False,3114420536103,0.0,966.97,267518.93,Important,vedika
775,776,03/03/2023,Grocery,False,3713203361135,0.0,2667.2,270186.13,Non-important,vedika
776,777,04/03/2023,Movies,False,3662786601089,0.0,994.86,271180.99,Non-Essential,vedika
777,778,04/03/2023,Beauty,True,3135363847969,3407.26,0.0,267773.73,Essential,vedika
778,779,04/03/2023,Baby,True,3825404345730,4483.03,0.0,263290.7,Non-Essential,vedika
779,780,04/03/2023,Sports,True,3666597906875,4724.15,0.0,258566.55,Important,vedika
780,781,04/03/2023,Garden,True,3734510472850,973.23,0.0,257593.32,Non-Essential,vedika
781,782,04/03/2023,Garden,True,3578419273953,2958.94,0.0,254634.38,Essential,vedika
782,783,04/03/2023,Automotive,False,3829095665792,0.0,1411.05,256045.43,Essential,vedika
783,784,04/03/2023,Jewelry,False,3644684611185,0.0,1382.99,257428.42,Essential,vedika
784,785,04/03/2023,Computers,True,3112686097967,1212.2,0.0,256216.22,Essential,vedika
785,786,04/03/2023,Baby,False,3620291919056,0.0,751.86,256968.08,Essential,vedika
786,787,04/03/2023,Movies,True,3779637154403,1923.02,0.0,255045.06,Important,vedika
787,788,04/03/2023,Baby,False,3315061397576,0.0,2121.36,257166.42,Important,vedika
788,789,05/03/2023,Baby,True,3192916161069,700.58,0.0,256465.84,Essential,vedika
789,790,05/03/2023,Clothing,False,3883649006335,0.0,2534.39,259000.23,Non-Essential,vedika
790,791,05/03/2023,Tools,False,3703236616471,0.0,1915.03,260915.26,Essential,vedika
791,792,05/03/2023,Games,True,3165430443191,3428.08,0.0,257487.18,Essential,vedika
792,793,05/03/2023,Garden,False,3394865854244,0.0,1823.09,259310.27,Essential,vedika
793,794,05/03/2023,Beauty,False,3439722750206,0.0,1667.64,260977.91,Non-Essential,vedika
794,795,05/03/2023,Kids,True,3959924733198,1995.56,0.0,258982.35,Essential,vedika
795,796,05/03/2023,Kids,False,3415637678660,0.0,455.13,259437.48,Non-Essential,vedika
796,797,05/03/2023,Electronics,True,3962890531503,519.58,0.0,258917.9,Important,vedika
797,798,05/03/2023,Sports,False,3870781277827,0.0,2635.03,261552.93,Essential,vedika
798,799,05/03/2023,Garden,False,3450974394521,0.0,2738.66,264291.59,Non-important,vedika
799,800,05/03/2023,Jewelry,True,3497526924819,307.05,0.0,263984.54,Important,vedika
800,801,06/03/2023,Clothing,False,3361544335106,0.0,2618.19,266602.73,Non-Essential,vedika
801,802,06/03/2023,Kids,True,3144322641724,1329.27,0.0,265273.46,Non-important,vedika
802,803,06/03/2023,Outdoors,False,3615449563323,0.0,630.47,265903.93,Essential,vedika
803,804,06/03/2023,Kids,True,3237831981293,1421.33,0.0,264482.6,Important,vedika
804,805,06/03/2023,Baby,False,3182607865345,0.0,1309.59,265792.19,Non-Essential,vedika
805,806,06/03/2023,Computers,False,3996850630089,0.0,1951.13,267743.32,Non-important,vedika
806,807,06/03/2023,Automotive,False,3680110587952,0.0,2230.68,269974.0,Important,vedika
807,808,06/03/2023,Books,True,3127528583549,37.38,0.0,269936.62,Non-Essential,vedika
808,809,06/03/2023,Jewelry,False,3804271092034,0.0,1763.24,271699.86,Non-important,vedika
809,810,06/03/2023,Music,True,3732208323678,403.3,0.0,271296.56,Non-Essential,vedika
810,811,06/03/2023,Movies,True,3173718411617,2492.84,0.0,268803.72,Essential,vedika
811,812,06/03/2023,Books,True,3941380895966,2421.7,0.0,266382.02,Important,vedika
812,813,06/03/2023,Movies,True,3067302213393,1046.2,0.0,265335.82,Essential,vedika
813,814,07/03/2023,Clothing,True,3981659027898,3519.42,0.0,261816.4,Essential,vedika
814,815,07/03/2023,Clothing,False,3164437984659,0.0,1739.94,263556.34,Essential,vedika
815,816,07/03/2023,Beauty,False,3774472361210,0.0,2135.69,265692.03,Important,vedika
816,817,07/03/2023,Electronics,True,3628274484146,472.07,0.0,265219.96,Important,vedika
817,818,07/03/2023,Baby,False,3166799049867,0.0,791.05,266011.01,Essential,vedika
818,819,07/03/2023,Automotive,True,3034979700260,14.34,0.0,265996.67,Essential,vedika
819,820,07/03/2023,Electronics,True,3400948356641,2625.51,0.0,263371.16,Non-important,vedika
820,821,08/03/2023,Jewelry,True,3792390034659,371.93,0.0,262999.23,Non-important,vedika
821,822,08/03/2023,Music,False,3854159533074,0.0,1537.4,264536.63,Important,vedika
822,823,08/03/2023,Movies,False,3729782890604,0.0,442.77,264979.4,Non-Essential,vedika
823,824,08/03/2023,Electronics,True,3866774443618,4257.32,0.0,260722.08,Essential,vedika
824,825,08/03/2023,Music,True,3822084481234,2607.95,0.0,258114.13,Important,vedika
825,826,08/03/2023,Movies,True,3553075680024,660.61,0.0,257453.52,Non-important,vedika
826,827,08/03/2023,Sports,True,3666386228473,4917.58,0.0,252535.94,Non-Essential,vedika
827,828,08/03/2023,Computers,True,3849772341702,3253.44,0.0,249282.5,Non-important,vedika
828,829,08/03/2023,Clothing,True,3939035326800,1486.63,0.0,247795.87,Non-Essential,vedika
829,830,08/03/2023,Home,True,3732718073388,251.72,0.0,247544.15,Non-important,vedika
830,831,08/03/2023,Jewelry,True,3039297968835,1330.75,0.0,246213.4,Important,vedika
831,832,08/03/2023,Clothing,True,3588290943273,1863.42,0.0,244349.98,Important,vedika
832,833,08/03/2023,Baby,True,3966050759879,898.79,0.0,243451.19,Important,vedika
833,834,09/03/2023,Books,True,3748242028494,2246.62,0.0,241204.57,Non-important,vedika
834,835,09/03/2023,Industrial,False,3635664867636,0.0,2521.25,243725.82,Non-important,vedika
835,836,09/03/2023,Sports,True,3126869884529,3348.11,0.0,240377.71,Non-important,vedika
836,837,09/03/2023,Kids,True,3533780634655,2939.42,0.0,237438.29,Non-important,vedika
837,838,09/03/2023,Movies,True,3263668866545,4967.46,0.0,232470.83,Important,vedika
838,839,09/03/2023,Music,False,3666723433394,0.0,507.66,232978.49,Non-important,vedika
839,840,09/03/2023,Automotive,True,3782257854237,4944.97,0.0,228033.52,Important,vedika
840,841,09/03/2023,Computers,False,3018907416014,0.0,2029.38,230062.9,Essential,vedika
841,842,09/03/2023,Sports,False,3703928364404,0.0,60.64,230123.54,Essential,vedika
842,843,09/03/2023,Sports,False,3288475780044,0.0,2296.44,232419.98,Non-Essential,vedika
843,844,09/03/2023,Health,False,3852052239425,0.0,852.45,233272.43,Essential,vedika
844,845,09/03/2023,Outdoors,True,3926755406984,3224.13,0.0,230048.3,Important,vedika
845,846,10/03/2023,Shoes,True,3482777402898,3681.59,0.0,226366.71,Non-Essential,vedika
846,847,10/03/2023,Outdoors,True,3895597441310,3302.07,0.0,223064.64,Non-Essential,vedika
847,848,10/03/2023,Clothing,True,3922147501597,3775.01,0.0,219289.63,Important,vedika
848,849,10/03/2023,Electronics,True,3194325137945,2641.89,0.0,216647.74,Non-important,vedika
849,850,10/03/2023,Books,False,3350865945856,0.0,2603.95,219251.69,Essential,vedika
850,851,10/03/2023,Kids,True,3531086726068,312.47,0.0,218939.22,Essential,vedika
851,852,10/03/2023,Industrial,True,3876134523059,4868.28,0.0,214070.94,Important,vedika
852,853,10/03/2023,Movies,False,3205170733737,0.0,1387.63,215458.57,Important,vedika
853,854,10/03/2023,Music,True,3095564736991,1510.02,0.0,213948.55,Important,vedika
854,855,10/03/2023,Garden,True,3432380578895,3676.69,0.0,210271.86,Non-important,vedika
855,856,10/03/2023,Outdoors,True,3902267519280,3984.62,0.0,206287.24,Essential,vedika
856,857,10/03/2023,Tools,True,3539469607217,4807.22,0.0,201480.02,Non-important,vedika
857,858,11/03/2023,Health,False,3603194593724,0.0,1213.77,202693.79,Essential,vedika
858,859,11/03/2023,Tools,False,3734790694237,0.0,2104.36,204798.15,Essential,vedika
859,860,11/03/2023,Toys,True,3875473612769,4710.22,0.0,200087.93,Important,vedika
860,861,11/03/2023,Computers,False,3731343401375,0.0,1410.25,201498.18,Important,vedika
861,862,11/03/2023,Computers,True,3830251037185,3146.39,0.0,198351.79,Non-Essential,vedika
862,863,11/03/2023,Baby,False,3714363416916,0.0,1581.27,199933.06,Non-important,vedika
863,864,11/03/2023,Toys,True,3642138346399,2265.05,0.0,197668.01,Non-Essential,vedika
864,865,11/03/2023,Home,False,3365971415584,0.0,553.86,198221.87,Essential,vedika
865,866,11/03/2023,Home,False,3859245582171,0.0,2752.66,200974.53,Non-Essential,vedika
866,867,11/03/2023,Outdoors,True,3310875456136,684.62,0.0,200289.91,Non-Essential,vedika
867,868,12/03/2023,Sports,False,3501086799694,0.0,771.43,201061.34,Non-important,vedika
868,869,12/03/2023,Sports,False,3116982859489,0.0,2904.31,203965.65,Essential,vedika
869,870,12/03/2023,Home,False,3854040110135,0.0,2919.91,206885.56,Non-important,vedika
870,871,12/03/2023,Outdoors,False,3283405691105,0.0,2717.15,209602.71,Non-Essential,vedika
871,872,12/03/2023,Jewelry,False,3467963732662,0.0,607.82,210210.53,Important,vedika
872,873,12/03/2023,Baby,True,3288926229399,4728.77,0.0,205481.76,Important,vedika
873,874,12/03/2023,Industrial,False,3346242485642,0.0,470.78,205952.54,Non-important,vedika
874,875,12/03/2023,Beauty,True,3361391961599,3547.03,0.0,202405.51,Important,vedika
875,876,12/03/2023,Tools,True,3866987284968,2554.27,0.0,199851.24,Important,vedika
876,877,12/03/2023,Sports,True,3708196075615,2824.77,0.0,197026.47,Non-Essential,vedika
877,878,12/03/2023,Movies,False,3290723455665,0.0,1344.49,198370.96,Non-Essential,vedika
878,879,12/03/2023,Games,False,3080182955133,0.0,1993.05,200364.01,Non-important,vedika
879,880,12/03/2023,Books,False,3495307169840,0.0,1625.22,201989.23,Non-important,vedika
880,881,12/03/2023,Home,False,3991397205811,0.0,1288.11,203277.34,Non-important,vedika
881,882,12/03/2023,Kids,False,3866182214967,0.0,2250.88,205528.22,Non-important,vedika
882,883,12/03/2023,Grocery,False,3081827805394,0.0,1184.91,206713.13,Essential,vedika
883,884,12/03/2023,Shoes,False,3479967073470,0.0,466.83,207179.96,Essential,vedika
884,885,13/03/2023,Baby,True,3359507752855,1798.11,0.0,205381.85,Important,vedika
885,886,13/03/2023,Garden,False,3103176517261,0.0,864.13,206245.98,Non-Essential,vedika
886,887,13/03/2023,Music,True,3596639804754,1325.23,0.0,204920.75,Essential,vedika
887,888,13/03/2023,Movies,False,3046919516936,0.0,1684.25,206605.0,Important,vedika
888,889,13/03/2023,Outdoors,False,3612857163341,0.0,1674.74,208279.74,Non-Essential,vedika
889,890,13/03/2023,Music,False,3321280517528,0.0,328.23,208607.97,Non-Essential,vedika
890,891,13/03/2023,Health,True,3012915069946,988.65,0.0,207619.32,Essential,vedika
891,892,13/03/2023,Music,False,3144770097020,0.0,1277.23,208896.55,Essential,vedika
892,893,13/03/2023,Jewelry,True,3766600020636,1398.74,0.0,207497.81,Non-Essential,vedika
893,894,13/03/2023,Toys,False,3696566651162,0.0,658.01,208155.82,Essential,vedika
894,895,14/03/2023,Computers,False,3283886174770,0.0,760.27,208916.09,Essential,vedika
895,896,14/03/2023,Outdoors,False,3434188854208,0.0,2174.26,211090.35,Non-Essential,vedika
896,897,14/03/2023,Garden,True,3913058548701,2119.28,0.0,208971.07,Important,vedika
897,898,14/03/2023,Beauty,False,3483839959410,0.0,1061.08,210032.15,Important,vedika
898,899,14/03/2023,Industrial,False,3015008277230,0.0,1607.74,211639.89,Non-important,vedika
899,900,14/03/2023,Movies,True,3359409396777,990.33,0.0,210649.56,Important,vedika
900,901,14/03/2023,Computers,False,3546239117425,0.0,2986.43,213635.99,Essential,vedika
901,902,14/03/2023,Beauty,False,3098547066332,0.0,453.3,214089.29,Essential,vedika
902,903,14/03/2023,Books,False,3209832214428,0.0,229.89,214319.18,Non-Essential,vedika
903,904,14/03/2023,Electronics,True,3215882021889,718.13,0.0,213601.05,Important,vedika
904,905,14/03/2023,Clothing,True,3258086561798,4731.24,0.0,208869.81,Non-Essential,vedika
905,906,14/03/2023,Garden,True,3947677176233,1630.87,0.0,207238.94,Important,vedika
906,907,15/03/2023,Games,False,3162607810364,0.0,850.26,208089.2,Non-Essential,vedika
907,908,15/03/2023,Computers,False,3884937239299,0.0,2029.45,210118.65,Important,vedika
908,909,15/03/2023,Beauty,False,3037972636194,0.0,1299.25,211417.9,Non-Essential,vedika
909,910,15/03/2023,Clothing,False,3007035703316,0.0,2118.93,213536.83,Essential,vedika
910,911,15/03/2023,Grocery,False,3786761384166,0.0,2234.58,215771.41,Non-Essential,vedika
911,912,15/03/2023,Electronics,False,3745050674806,0.0,2754.83,218526.24,Non-important,vedika
912,913,15/03/2023,Outdoors,True,3941544397424,3648.87,0.0,214877.37,Essential,vedika
913,914,15/03/2023,Industrial,True,3145883973205,35.35,0.0,214842.02,Non-Essential,vedika
914,915,15/03/2023,Outdoors,True,3539751217997,4920.22,0.0,209921.8,Essential,vedika
915,916,15/03/2023,Games,True,3402359438329,3273.28,0.0,206648.52,Non-important,vedika
916,917,15/03/2023,Movies,False,3238185323130,0.0,1792.82,208441.34,Important,vedika
917,918,15/03/2023,Jewelry,False,3716833980221,0.0,1060.2,209501.54,Non-important,vedika
918,919,15/03/2023,Baby,False,3882086389785,0.0,1266.02,210767.56,Non-Essential,vedika
919,920,15/03/2023,Beauty,True,3804308652905,3074.28,0.0,207693.28,Essential,vedika
920,921,15/03/2023,Movies,True,3894754244863,425.39,0.0,207267.89,Essential,vedika
921,922,16/03/2023,Music,False,3138356601637,0.0,2164.58,209432.47,Important,vedika
922,923,16/03/2023,Music,True,3123793910071,317.0,0.0,209115.47,Non-Essential,vedika
923,924,16/03/2023,Beauty,True,3439686725908,1240.8,0.0,207874.67,Important,vedika
924,925,16/03/2023,Computers,False,3097384775710,0.0,1208.57,209083.24,Non-Essential,vedika
925,926,16/03/2023,Shoes,True,3369505028196,511.83,0.0,208571.41,Non-Essential,vedika
926,927,16/03/2023,Clothing,False,3877339377527,0.0,1820.51,210391.92,Non-Essential,vedika
927,928,16/03/2023,Home,True,3972988360027,1778.94,0.0,208612.98,Non-important,vedika
928,929,16/03/2023,Garden,False,3378026058921,0.0,756.09,209369.07,Essential,vedika
929,930,16/03/2023,Movies,False,3877498255603,0.0,1083.67,210452.74,Non-important,vedika
930,931,16/03/2023,Garden,False,3430497796632,0.0,2541.4,212994.14,Essential,vedika
931,932,16/03/2023,Clothing,True,3290151222297,3254.83,0.0,209739.31,Non-important,vedika
932,933,16/03/2023,Beauty,False,3597742001397,0.0,678.64,210417.95,Non-important,vedika
933,934,16/03/2023,Clothing,False,3937564130816,0.0,114.21,210532.16,Essential,vedika
934,935,17/03/2023,Industrial,True,3690535152963,2469.57,0.0,208062.59,Important,vedika
935,936,17/03/2023,Toys,True,3161891839593,734.92,0.0,207327.67,Essential,vedika
936,937,17/03/2023,Shoes,False,3375682946527,0.0,2998.44,210326.11,Important,vedika
937,938,17/03/2023,Clothing,True,3162503215679,4600.4,0.0,205725.71,Non-important,vedika
938,939,17/03/2023,Automotive,False,3426469011652,0.0,1218.06,206943.77,Essential,vedika
939,940,17/03/2023,Sports,False,3962133753555,0.0,352.18,207295.95,Essential,vedika
940,941,17/03/2023,Computers,False,3271172629641,0.0,1293.1,208589.05,Important,vedika
941,942,17/03/2023,Grocery,True,3789520088789,2078.22,0.0,206510.83,Essential,vedika
942,943,17/03/2023,Industrial,True,3016184956424,1859.47,0.0,204651.36,Important,vedika
943,944,17/03/2023,Home,False,3347915119164,0.0,46.33,204697.69,Essential,vedika
944,945,17/03/2023,Grocery,False,3456216648231,0.0,517.13,205214.82,Essential,vedika
945,946,17/03/2023,Movies,True,3141616005740,3867.86,0.0,201346.96,Important,vedika
946,947,17/03/2023,Grocery,True,3698002659074,1789.02,0.0,199557.94,Non-Essential,vedika
947,948,18/03/2023,Tools,True,3382256405484,453.3,0.0,199104.64,Non-Essential,vedika
948,949,18/03/2023,Sports,True,3800811369251,4967.93,0.0,194136.71,Important,vedika
949,950,18/03/2023,Music,True,3518322389610,4939.17,0.0,189197.54,Non-important,vedika
950,951,18/03/2023,Sports,True,3933371239057,575.78,0.0,188621.76,Essential,vedika
951,952,18/03/2023,Garden,False,3929371034180,0.0,1259.42,189881.18,Non-Essential,vedika
952,953,18/03/2023,Baby,True,3692548797402,3418.94,0.0,186462.24,Non-Essential,vedika
953,954,18/03/2023,Industrial,False,3262805626516,0.0,2455.99,188918.23,Essential,vedika
954,955,18/03/2023,Grocery,False,3818146785456,0.0,186.02,189104.25,Essential,vedika
955,956,18/03/2023,Outdoors,True,3156919474740,2776.08,0.0,186328.17,Non-Essential,vedika
956,957,19/03/2023,Computers,True,3799846145397,4545.44,0.0,181782.73,Important,vedika
957,958,19/03/2023,Tools,True,3588198883443,3752.22,0.0,178030.51,Non-important,vedika
958,959,19/03/2023,Electronics,True,3799828363529,436.08,0.0,177594.43,Essential,vedika
959,960,19/03/2023,Movies,True,3463573982589,1827.58,0.0,175766.85,Important,vedika
960,961,19/03/2023,Music,True,3163855961560,599.33,0.0,175167.52,Important,vedika
961,962,19/03/2023,Industrial,False,3949895684013,0.0,352.88,175520.4,Non-important,vedika
962,963,19/03/2023,Beauty,True,3553508894703,1959.16,0.0,173561.24,Non-important,vedika
963,964,19/03/2023,Garden,True,3599639528149,3345.65,0.0,170215.59,Non-Essential,vedika
964,965,19/03/2023,Games,False,3097308327561,0.0,401.13,170616.72,Essential,vedika
965,966,19/03/2023,Shoes,False,3972315380576,0.0,1509.81,172126.53,Essential,vedika
966,967,20/03/2023,Automotive,True,3191907865640,919.98,0.0,171206.55,Important,vedika
967,968,20/03/2023,Garden,True,3769584057583,2542.09,0.0,168664.46,Essential,vedika
968,969,20/03/2023,Industrial,True,3035526354726,674.44,0.0,167990.02,Non-Essential,vedika
969,970,20/03/2023,Clothing,False,3741031029235,0.0,2817.02,170807.04,Essential,vedika
970,971,20/03/2023,Tools,True,3283996937853,3400.82,0.0,167406.22,Non-important,vedika
971,972,20/03/2023,Sports,False,3074135010145,0.0,782.28,168188.5,Essential,vedika
972,973,20/03/2023,Computers,True,3924385728588,4314.45,0.0,163874.05,Non-important,vedika
973,974,20/03/2023,Baby,False,3709590856815,0.0,681.18,164555.23,Important,vedika
974,975,20/03/2023,Movies,True,3814815195908,314.98,0.0,164240.25,Important,vedika
975,976,21/03/2023,Garden,True,3929780377864,3938.92,0.0,160301.33,Important,vedika
976,977,21/03/2023,Outdoors,True,3454684326322,80.02,0.0,160221.31,Important,vedika
977,978,21/03/2023,Jewelry,True,3668703632825,72.37,0.0,160148.94,Non-Essential,vedika
978,979,21/03/2023,Home,False,3989075622685,0.0,1359.77,161508.71,Non-Essential,vedika
979,980,21/03/2023,Shoes,False,3505154417995,0.0,936.07,162444.78,Important,vedika
980,981,21/03/2023,Baby,True,3549638164346,3019.36,0.0,159425.42,Non-important,vedika
981,982,21/03/2023,Beauty,False,3580645180027,0.0,1973.5,161398.92,Non-Essential,vedika
982,983,21/03/2023,Shoes,True,3766194337092,265.65,0.0,161133.27,Non-Essential,vedika
983,984,21/03/2023,Health,True,3696810935975,2228.92,0.0,158904.35,Non-Essential,vedika
984,985,21/03/2023,Jewelry,True,3710812376008,4826.19,0.0,154078.16,Important,vedika
985,986,21/03/2023,Automotive,False,3467732807010,0.0,2704.12,156782.28,Important,vedika
986,987,22/03/2023,Computers,False,3719122782165,0.0,691.8,157474.08,Non-Essential,vedika
987,988,22/03/2023,Sports,True,3421544600041,1741.96,0.0,155732.12,Essential,vedika
988,989,22/03/2023,Automotive,True,3548791280175,503.49,0.0,155228.63,Non-Essential,vedika
989,990,22/03/2023,Industrial,True,3417559917694,4215.69,0.0,151012.94,Non-important,vedika
990,991,22/03/2023,Outdoors,False,3398663527189,0.0,2885.52,153898.46,Non-important,vedika
991,992,22/03/2023,Toys,False,3869203488018,0.0,1862.16,155760.62,Important,vedika
992,993,22/03/2023,Computers,True,3040534236401,4132.4,0.0,151628.22,Essential,vedika
993,994,22/03/2023,Tools,True,3271612637800,3954.77,0.0,147673.45,Important,vedika
994,995,22/03/2023,Computers,False,3353225381794,0.0,2387.06,150060.51,Non-important,vedika
995,996,22/03/2023,Automotive,False,3939763908695,0.0,1543.38,151603.89,Essential,vedika
996,997,22/03/2023,Industrial,False,3531752310735,0.0,2712.97,154316.86,Non-Essential,vedika
997,998,22/03/2023,Beauty,True,3884303237766,4344.67,0.0,149972.19,Essential,vedika
998,999,22/03/2023,Health,True,3461989086280,1280.5,0.0,148691.69,Non-Essential,vedika
999,1000,22/03/2023,Outdoors,False,3454836974048,0.0,2969.34,151661.03,Non-important,vedika
