row,Txn Date,Description,Transfer To/From,Ref No./Cheque No.,Debit,Credit,Balance,Class
1,25/12/2022,Home,true,1216711285639,4305.53,0.00,366736.40,Important
2,25/12/2022,Movies,false,1628188928766,0.00,4931.10,371667.50,Non-important
3,25/12/2022,Tools,false,1845200544154,0.00,1068.89,372736.39,Essential
4,25/12/2022,Computers,true,1158881602293,3224.64,0.00,369511.75,Non-important
5,25/12/2022,Baby,true,1155313314792,3929.41,0.00,365582.34,Non-Essential
6,25/12/2022,Outdoors,true,1964064057056,4919.93,0.00,360662.41,Important
7,25/12/2022,Shoes,true,1410165680332,2472.18,0.00,358190.23,Essential
8,25/12/2022,Shoes,true,1787909248407,4627.36,0.00,353562.87,Non-Essential
9,26/12/2022,Movies,true,1111178882578,4093.32,0.00,349469.55,Non-Essential
10,26/12/2022,Jewelry,true,1901839865372,4615.39,0.00,344854.16,Important
11,26/12/2022,Baby,false,1149849741213,0.00,4208.60,349062.76,Non-important
12,26/12/2022,Games,false,1061688235863,0.00,4710.66,353773.42,Important
13,26/12/2022,Electronics,false,1515784777170,0.00,3961.57,357734.99,Non-important
14,26/12/2022,Jewelry,true,1946307926887,4759.78,0.00,352975.21,Non-Essential
15,26/12/2022,Home,false,1910853350499,0.00,4451.46,357426.67,Non-Essential
16,26/12/2022,Music,false,1761503465919,0.00,2606.75,360033.42,Important
17,26/12/2022,Computers,true,1427324837447,2328.02,0.00,357705.40,Non-Essential
18,27/12/2022,Toys,true,1886038371412,2444.28,0.00,355261.12,Essential
19,27/12/2022,Shoes,true,1271566407268,1713.71,0.00,353547.41,Non-important
20,27/12/2022,Books,true,1530899363843,1166.56,0.00,352380.85,Important
21,27/12/2022,Home,false,1945203778016,0.00,2347.74,354728.59,Non-important
22,27/12/2022,Books,true,1509229677958,1377.66,0.00,353350.93,Important
23,27/12/2022,Automotive,false,1822776952425,0.00,1032.86,354383.79,Important
24,27/12/2022,Music,false,1333215835490,0.00,1741.08,356124.87,Non-important
25,27/12/2022,Sports,false,1600412225837,0.00,332.84,356457.71,Non-Essential
26,27/12/2022,Games,false,1393813692289,0.00,3913.05,360370.76,Non-Essential
27,27/12/2022,Movies,false,1901544986917,0.00,1644.06,362014.82,Important
28,27/12/2022,Garden,false,1083092453533,0.00,3136.60,365151.42,Non-Essential
29,27/12/2022,Beauty,true,1582489008714,2772.05,0.00,362379.37,Essential
30,27/12/2022,Jewelry,true,1832928677427,3216.62,0.00,359162.75,Non-Essential
31,28/12/2022,Grocery,false,1478722462634,0.00,747.41,359910.16,Non-Essential
32,28/12/2022,Beauty,false,1391887194180,0.00,2466.87,362377.03,Non-important
33,28/12/2022,Automotive,false,1358791895777,0.00,1215.04,363592.07,Important
34,28/12/2022,Music,false,1600186255376,0.00,3660.92,367252.99,Non-important
35,28/12/2022,Baby,false,1078274897799,0.00,4936.88,372189.87,Important
36,28/12/2022,Home,true,1214682968682,2340.85,0.00,369849.02,Non-important
37,28/12/2022,Clothing,true,1891792734290,3290.69,0.00,366558.33,Non-important
38,28/12/2022,Beauty,true,1886603388091,1198.19,0.00,365360.14,Non-important
39,28/12/2022,Movies,true,1257463513404,4138.86,0.00,361221.28,Essential
40,28/12/2022,Music,true,1134116591041,336.56,0.00,360884.72,Non-Essential
41,28/12/2022,Garden,true,1695327523713,3854.66,0.00,357030.06,Non-Essential
42,28/12/2022,Computers,true,1440121417025,2815.28,0.00,354214.78,Non-important
43,29/12/2022,Sports,true,1633489556058,3771.93,0.00,350442.85,Important
44,29/12/2022,Baby,true,1018121992677,3848.96,0.00,346593.89,Non-Essential
45,29/12/2022,Outdoors,true,1612232915050,2033.23,0.00,344560.66,Essential
46,29/12/2022,Computers,true,1138054035843,3208.47,0.00,341352.19,Important
47,29/12/2022,Industrial,true,1471112235020,2394.72,0.00,338957.47,Important
48,29/12/2022,Grocery,true,1659662908707,2409.25,0.00,336548.22,Important
49,29/12/2022,Automotive,true,1808385672309,3730.59,0.00,332817.63,Non-Essential
50,29/12/2022,Kids,true,1759160954543,676.03,0.00,332141.60,Important
51,29/12/2022,Grocery,true,1228215694230,2335.23,0.00,329806.37,Important
52,29/12/2022,Grocery,true,1032373825595,3005.96,0.00,326800.41,Important
53,29/12/2022,Grocery,true,1227606813167,1019.34,0.00,325781.07,Important
54,29/12/2022,Games,false,1657204363677,0.00,848.65,326629.72,Non-important
55,29/12/2022,Baby,false,1673351227407,0.00,3840.11,330469.83,Essential
56,30/12/2022,Movies,true,1238173367124,3214.33,0.00,327255.50,Non-Essential
57,30/12/2022,Garden,true,1256708972104,2690.57,0.00,324564.93,Important
58,30/12/2022,Kids,true,1637385288453,1821.74,0.00,322743.19,Non-important
59,30/12/2022,Clothing,false,1271212694279,0.00,3437.77,326180.96,Non-Essential
60,30/12/2022,Books,true,1248519481700,2355.00,0.00,323825.96,Essential
61,30/12/2022,Grocery,false,1183503730736,0.00,1145.35,324971.31,Non-Essential
62,30/12/2022,Automotive,false,1311726825901,0.00,3555.11,328526.42,Non-important
63,30/12/2022,Beauty,true,1566372447836,3620.33,0.00,324906.09,Important
64,30/12/2022,Sports,false,1918880348648,0.00,2647.61,327553.70,Non-Essential
65,30/12/2022,Grocery,true,1503183792831,3574.59,0.00,323979.11,Non-important
66,31/12/2022,Baby,false,1866577674451,0.00,1693.23,325672.34,Essential
67,31/12/2022,Movies,true,1169322313677,975.11,0.00,324697.23,Non-Essential
68,31/12/2022,Books,false,1827104923933,0.00,4898.27,329595.50,Essential
69,31/12/2022,Clothing,false,1632346197886,0.00,2996.52,332592.02,Non-important
70,31/12/2022,Electronics,true,1261259208539,4039.86,0.00,328552.16,Essential
71,31/12/2022,Industrial,false,1149007243478,0.00,2599.15,331151.31,Essential
72,31/12/2022,Electronics,false,1447696653968,0.00,4597.82,335749.13,Non-important
73,31/12/2022,Electronics,false,1167397396882,0.00,4495.36,340244.49,Important
74,31/12/2022,Grocery,true,1718528834755,449.98,0.00,339794.51,Essential
75,31/12/2022,Health,true,1751025592804,4025.53,0.00,335768.98,Non-Essential
76,31/12/2022,Outdoors,false,1540073735547,0.00,3865.86,339634.84,Non-Essential
77,31/12/2022,Grocery,false,1717262253415,0.00,2299.55,341934.39,Non-Essential
78,31/12/2022,Shoes,false,1714145035231,0.00,1546.42,343480.81,Non-important
79,31/12/2022,Industrial,true,1490360538691,4298.32,0.00,339182.49,Important
80,31/12/2022,Electronics,true,1281807723542,4871.63,0.00,334310.86,Important
81,01/01/2023,Automotive,true,1194306271601,1332.71,0.00,332978.15,Non-important
82,01/01/2023,Electronics,false,1432859331639,0.00,773.22,333751.37,Important
83,01/01/2023,Music,false,1334708259188,0.00,4746.36,338497.73,Essential
84,01/01/2023,Jewelry,false,1656967103721,0.00,1274.81,339772.54,Non-important
85,01/01/2023,Grocery,false,1639851096426,0.00,211.35,339983.89,Non-important
86,01/01/2023,Baby,false,1231310021210,0.00,2323.77,342307.66,Important
87,01/01/2023,Music,true,1785500168291,4616.63,0.00,337691.03,Essential
88,01/01/2023,Games,false,1213005717332,0.00,4759.59,342450.62,Non-important
89,01/01/2023,Shoes,true,1385830127297,2166.71,0.00,340283.91,Essential
90,01/01/2023,Kids,false,1893065931744,0.00,4570.27,344854.18,Non-Essential
91,01/01/2023,Movies,false,1300086563511,0.00,4474.94,349329.12,Non-important
92,02/01/2023,Music,true,1288104832546,3382.48,0.00,345946.64,Important
93,02/01/2023,Music,false,1673433409918,0.00,2521.66,348468.30,Essential
94,02/01/2023,Electronics,true,1663731648489,3860.92,0.00,344607.38,Non-Essential
95,02/01/2023,Toys,true,1309323608707,2766.53,0.00,341840.85,Non-Essential
96,02/01/2023,Outdoors,true,1654982258739,1964.92,0.00,339875.93,Essential
97,02/01/2023,Electronics,true,1889988388729,880.57,0.00,338995.36,Essential
98,02/01/2023,Home,true,1439734087787,3398.96,0.00,335596.40,Non-Essential
99,02/01/2023,Automotive,true,1484581392252,1650.74,0.00,333945.66,Important
100,02/01/2023,Games,true,1453073220555,4053.93,0.00,329891.73,Non-important
101,02/01/2023,Garden,false,1502745278152,0.00,3169.71,333061.44,Non-Essential
102,03/01/2023,Beauty,true,1364196271047,853.39,0.00,332208.05,Important
103,03/01/2023,Toys,true,1408161244833,2600.56,0.00,329607.49,Non-Essential
104,03/01/2023,Automotive,true,1188522627376,1595.55,0.00,328011.94,Essential
105,03/01/2023,Electronics,true,1188098393559,22.59,0.00,327989.35,Non-important
106,03/01/2023,Grocery,true,1379768534678,2448.91,0.00,325540.44,Non-important
107,03/01/2023,Beauty,false,1230552873404,0.00,2029.44,327569.88,Non-important
108,03/01/2023,Toys,true,1846125166715,1411.61,0.00,326158.27,Important
109,03/01/2023,Music,true,1631990741532,4998.89,0.00,321159.38,Non-important
110,03/01/2023,Music,false,1461091295372,0.00,4762.03,325921.41,Non-Essential
111,03/01/2023,Baby,true,1040004469347,4591.68,0.00,321329.73,Essential
112,03/01/2023,Games,false,1107189126534,0.00,591.84,321921.57,Essential
113,03/01/2023,Beauty,true,1386805672134,2422.08,0.00,319499.49,Essential
114,04/01/2023,Kids,true,1668577407752,3646.98,0.00,315852.51,Essential
115,04/01/2023,Shoes,false,1348658380106,0.00,1930.73,317783.24,Non-Essential
116,04/01/2023,Garden,false,1990893085882,0.00,196.45,317979.69,Non-Essential
117,04/01/2023,Industrial,true,1217474410385,387.95,0.00,317591.74,Essential
118,04/01/2023,Jewelry,true,1090914120470,2201.60,0.00,315390.14,Essential
119,04/01/2023,Garden,false,1127774834594,0.00,1236.30,316626.44,Essential
120,04/01/2023,Shoes,true,1749182004580,1120.49,0.00,315505.95,Non-important
121,04/01/2023,Garden,false,1084147676159,0.00,715.20,316221.15,Non-important
122,04/01/2023,Grocery,true,1713773539918,1606.30,0.00,314614.85,Essential
123,04/01/2023,Sports,true,1927853784163,2532.17,0.00,312082.68,Essential
124,04/01/2023,Industrial,true,1406688514780,3828.51,0.00,308254.17,Essential
125,04/01/2023,Outdoors,false,1657197813833,0.00,1088.14,309342.31,Essential
126,05/01/2023,Clothing,true,1799631306396,679.44,0.00,308662.87,Non-important
127,05/01/2023,Grocery,false,1123204772104,0.00,4701.31,313364.18,Essential
128,05/01/2023,Home,false,1223070022979,0.00,1103.69,314467.87,Important
129,05/01/2023,Toys,true,1752184386779,770.89,0.00,313696.98,Non-important
130,05/01/2023,Outdoors,false,1452518574120,0.00,3827.60,317524.58,Non-important
131,05/01/2023,Home,false,1258136962179,0.00,4056.56,321581.14,Essential
132,05/01/2023,Kids,false,1910394744699,0.00,2673.23,324254.37,Essential
133,05/01/2023,Shoes,false,1594853780377,0.00,3966.80,328221.17,Non-important
134,05/01/2023,Movies,true,1995246108893,1421.48,0.00,326799.69,Non-important
135,06/01/2023,Grocery,true,1902077168219,1234.36,0.00,325565.33,Important
136,06/01/2023,Jewelry,false,1471391289645,0.00,2032.72,327598.05,Essential
137,06/01/2023,Industrial,false,1600335973308,0.00,1479.95,329078.00,Non-important
138,06/01/2023,Baby,false,1738976206203,0.00,2931.08,332009.08,Essential
139,06/01/2023,Home,true,1218815897928,4783.75,0.00,327225.33,Non-Essential
140,06/01/2023,Electronics,true,1996677474732,611.17,0.00,326614.16,Non-Essential
141,06/01/2023,Health,false,1365835078015,0.00,19.39,326633.55,Non-important
142,06/01/2023,Grocery,true,1123590614780,90.89,0.00,326542.66,Non-Essential
143,06/01/2023,Baby,false,1850965991702,0.00,410.47,326953.13,Essential
144,06/01/2023,Home,true,1535970797490,2473.78,0.00,324479.35,Non-Essential
145,06/01/2023,Outdoors,false,1142868459139,0.00,2095.13,326574.48,Essential
146,06/01/2023,Shoes,false,1314357367970,0.00,837.65,327412.13,Non-Essential
147,06/01/2023,Outdoors,false,1929328346058,0.00,153.27,327565.40,Essential
148,07/01/2023,Movies,false,1884898818261,0.00,141.09,327706.49,Essential
149,07/01/2023,Tools,false,1269797556286,0.00,3953.53,331660.02,Non-important
150,07/01/2023,Industrial,true,1914000998589,3614.44,0.00,328045.58,Essential
151,07/01/2023,Health,false,1564492273898,0.00,3582.79,331628.37,Essential
152,07/01/2023,Automotive,false,1191933754213,0.00,4254.32,335882.69,Important
153,07/01/2023,Kids,true,1065083475677,2339.12,0.00,333543.57,Non-important
154,07/01/2023,Music,false,1305045959734,0.00,539.76,334083.33,Essential
155,07/01/2023,Sports,false,1497626432427,0.00,3991.17,338074.50,Essential
156,07/01/2023,Automotive,false,1434735399158,0.00,4582.49,342656.99,Important
157,08/01/2023,Garden,false,1406827775679,0.00,2954.36,345611.35,Essential
158,08/01/2023,Outdoors,true,1184158518356,624.11,0.00,344987.24,Important
159,08/01/2023,Grocery,false,1668786032081,0.00,3792.10,348779.34,Non-Essential
160,08/01/2023,Health,true,1482036738178,3253.67,0.00,345525.67,Essential
161,08/01/2023,Games,false,1177054627052,0.00,1706.41,347232.08,Important
162,08/01/2023,Jewelry,false,1397730295820,0.00,3135.43,350367.51,Essential
163,09/01/2023,Garden,true,1314815020337,3329.69,0.00,347037.82,Non-Essential
164,09/01/2023,Electronics,false,1819924622714,0.00,2426.53,349464.35,Non-important
165,09/01/2023,Grocery,true,1775131737415,4699.32,0.00,344765.03,Essential
166,09/01/2023,Games,true,1952671516579,4021.45,0.00,340743.58,Essential
167,09/01/2023,Sports,false,1685125935239,0.00,2299.69,343043.27,Important
168,09/01/2023,Automotive,false,1366004575601,0.00,3275.35,346318.62,Essential
169,09/01/2023,Toys,true,1265545087584,3177.42,0.00,343141.20,Non-important
170,09/01/2023,Computers,false,1462967422083,0.00,2877.54,346018.74,Essential
171,09/01/2023,Baby,true,1192573332818,2736.10,0.00,343282.64,Non-important
172,09/01/2023,Electronics,true,1639373940174,563.52,0.00,342719.12,Non-important
173,09/01/2023,Sports,false,1971375090135,0.00,1713.47,344432.59,Important
174,09/01/2023,Computers,true,1717324534984,3827.02,0.00,340605.57,Essential
175,09/01/2023,Music,false,1001645990067,0.00,2032.19,342637.76,Non-important
176,10/01/2023,Garden,false,1337366768933,0.00,3692.23,346329.99,Important
177,10/01/2023,Books,false,1192542952887,0.00,734.21,347064.20,Non-Essential
178,10/01/2023,Toys,false,1224018720964,0.00,590.22,347654.42,Essential
179,10/01/2023,Books,false,1278497770308,0.00,3258.30,350912.72,Important
180,10/01/2023,Grocery,false,1838617278290,0.00,853.35,351766.07,Important
181,10/01/2023,Grocery,false,1942998045455,0.00,1704.08,353470.15,Important
182,10/01/2023,Beauty,true,1764149672126,607.19,0.00,352862.96,Essential
183,10/01/2023,Music,false,1112594127301,0.00,2714.28,355577.24,Non-Essential
184,10/01/2023,Books,true,1160441397734,3484.07,0.00,352093.17,Non-important
185,11/01/2023,Home,false,1011574406343,0.00,4612.63,356705.80,Important
186,11/01/2023,Jewelry,false,1991361959174,0.00,4509.93,361215.73,Essential
187,11/01/2023,Games,true,1583016388303,3332.85,0.00,357882.88,Important
188,11/01/2023,Jewelry,true,1347535727722,4049.79,0.00,353833.09,Non-important
189,11/01/2023,Games,false,1721872397417,0.00,2889.96,356723.05,Essential
190,11/01/2023,Kids,false,1219430220388,0.00,3262.00,359985.05,Non-important
191,11/01/2023,Electronics,true,1204072064962,2481.39,0.00,357503.66,Essential
192,11/01/2023,Industrial,true,1767786359392,277.96,0.00,357225.70,Non-important
193,11/01/2023,Automotive,false,1616111156003,0.00,1365.71,358591.41,Essential
194,12/01/2023,Kids,false,1447849502935,0.00,4200.43,362791.84,Non-Essential
195,12/01/2023,Kids,true,1558605550015,3439.86,0.00,359351.98,Important
196,12/01/2023,Tools,true,1359283461601,4066.16,0.00,355285.82,Non-Essential
197,12/01/2023,Automotive,true,1733415742999,710.20,0.00,354575.62,Important
198,12/01/2023,Sports,false,1576023049506,0.00,1801.53,356377.15,Essential
199,12/01/2023,Garden,false,1195231250431,0.00,2382.37,358759.52,Non-Essential
200,12/01/2023,Movies,false,1615467684998,0.00,2084.04,360843.56,Essential
201,12/01/2023,Jewelry,false,1709585006275,0.00,1673.16,362516.72,Non-important
202,12/01/2023,Clothing,true,1357153637664,4142.13,0.00,358374.59,Non-important
203,12/01/2023,Home,true,1303227510075,2578.23,0.00,355796.36,Non-Essential
204,12/01/2023,Clothing,false,1145215259523,0.00,160.02,355956.38,Non-Essential
205,12/01/2023,Beauty,false,1260780324432,0.00,4247.95,360204.33,Essential
206,12/01/2023,Clothing,true,1362785401175,2484.31,0.00,357720.02,Non-important
207,12/01/2023,Movies,false,1206410758754,0.00,3283.55,361003.57,Important
208,12/01/2023,Beauty,true,1139799221234,2826.56,0.00,358177.01,Non-Essential
209,13/01/2023,Outdoors,true,1867169154752,1730.09,0.00,356446.92,Non-Essential
210,13/01/2023,Music,true,1273452936680,4084.41,0.00,352362.51,Non-important
211,13/01/2023,Music,true,1777503558025,3399.91,0.00,348962.60,Non-important
212,13/01/2023,Jewelry,true,1548355649535,3581.89,0.00,345380.71,Important
213,13/01/2023,Grocery,true,1847160701218,4745.86,0.00,340634.85,Important
214,13/01/2023,Health,true,1872443446310,3858.69,0.00,336776.16,Important
215,13/01/2023,Music,true,1324110388095,3866.08,0.00,332910.08,Non-Essential
216,13/01/2023,Books,false,1481505816151,0.00,1116.96,334027.04,Non-important
217,14/01/2023,Kids,false,1847979675869,0.00,2218.32,336245.36,Essential
218,14/01/2023,Music,true,1632316899083,2118.53,0.00,334126.83,Non-Essential
219,14/01/2023,Computers,false,1014102143087,0.00,1139.88,335266.71,Non-Essential
220,14/01/2023,Tools,false,1259410158745,0.00,58.06,335324.77,Non-important
221,14/01/2023,Music,true,1309473372977,3158.69,0.00,332166.08,Essential
222,14/01/2023,Home,true,1000274269107,2064.25,0.00,330101.83,Essential
223,14/01/2023,Kids,false,1915419889322,0.00,2631.85,332733.68,Important
224,14/01/2023,Home,true,1374458583973,2491.94,0.00,330241.74,Non-important
225,14/01/2023,Clothing,false,1936558227236,0.00,1217.81,331459.55,Non-Essential
226,14/01/2023,Books,true,1341932636564,1874.40,0.00,329585.15,Important
227,14/01/2023,Books,false,1020991172147,0.00,3050.68,332635.83,Essential
228,15/01/2023,Games,false,1645171773836,0.00,2007.16,334642.99,Non-Essential
229,15/01/2023,Grocery,true,1550714076298,2303.87,0.00,332339.12,Essential
230,15/01/2023,Grocery,true,1458125065890,2582.15,0.00,329756.97,Essential
231,15/01/2023,Beauty,false,1037758770585,0.00,4020.34,333777.31,Non-important
232,15/01/2023,Shoes,true,1033937403545,2576.81,0.00,331200.50,Essential
233,15/01/2023,Clothing,true,1786520795248,4078.70,0.00,327121.80,Non-important
234,15/01/2023,Music,true,1684594253225,930.25,0.00,326191.55,Non-important
235,15/01/2023,Sports,false,1663555795041,0.00,1196.90,327388.45,Essential
236,15/01/2023,Garden,false,1092530794446,0.00,4834.56,332223.01,Important
237,15/01/2023,Toys,true,1025262480212,2842.06,0.00,329380.95,Non-important
238,15/01/2023,Garden,false,1764570428314,0.00,1380.03,330760.98,Non-Essential
239,15/01/2023,Industrial,true,1266278152102,4208.20,0.00,326552.78,Essential
240,15/01/2023,Computers,true,1831545171491,3389.88,0.00,323162.90,Essential
241,15/01/2023,Baby,false,1945822666351,0.00,2871.09,326033.99,Essential
242,15/01/2023,Outdoors,false,1818055062543,0.00,3913.51,329947.50,Non-Essential
243,15/01/2023,Jewelry,false,1271594208064,0.00,3926.57,333874.07,Important
244,15/01/2023,Music,true,1957760818465,2298.30,0.00,331575.77,Important
245,16/01/2023,Home,false,1515347891402,0.00,2323.36,333899.13,Non-Essential
246,16/01/2023,Kids,true,1555924032682,3352.71,0.00,330546.42,Non-important
247,16/01/2023,Tools,false,1379100098007,0.00,635.11,331181.53,Non-important
248,16/01/2023,Shoes,true,1868281539037,2738.73,0.00,328442.80,Non-important
249,16/01/2023,Books,false,1380859857120,0.00,4050.01,332492.81,Non-important
250,16/01/2023,Sports,false,1078223307129,0.00,4300.74,336793.55,Non-Essential
251,16/01/2023,Shoes,true,1433903914585,568.58,0.00,336224.97,Non-Essential
252,16/01/2023,Kids,false,1619828251337,0.00,2365.32,338590.29,Non-Essential
253,16/01/2023,Toys,false,1165240058266,0.00,1495.64,340085.93,Non-Essential
254,16/01/2023,Automotive,false,1397427896840,0.00,2484.95,342570.88,Essential
255,16/01/2023,Shoes,true,1386277208603,4219.18,0.00,338351.70,Non-Essential
256,17/01/2023,Sports,false,1828074320652,0.00,3307.42,341659.12,Non-Essential
257,17/01/2023,Baby,true,1457384834969,1780.27,0.00,339878.85,Important
258,17/01/2023,Beauty,true,1033892508286,86.48,0.00,339792.37,Non-Essential
259,17/01/2023,Beauty,false,1602327703897,0.00,181.29,339973.66,Essential
260,17/01/2023,Industrial,false,1243413441977,0.00,3427.28,343400.94,Essential
261,17/01/2023,Baby,false,1284000884113,0.00,1069.86,344470.80,Non-Essential
262,18/01/2023,Sports,true,1033115282812,2429.03,0.00,342041.77,Important
263,18/01/2023,Health,false,1475990694012,0.00,429.90,342471.67,Essential
264,18/01/2023,Outdoors,true,1778090182344,1750.04,0.00,340721.63,Non-important
265,18/01/2023,Grocery,false,1425972873088,0.00,1754.43,342476.06,Essential
266,18/01/2023,Books,false,1703284161515,0.00,1109.97,343586.03,Essential
267,18/01/2023,Baby,true,1660057184721,2533.97,0.00,341052.06,Important
268,18/01/2023,Health,true,1326367069633,1164.52,0.00,339887.54,Essential
269,18/01/2023,Sports,true,1858823953853,4033.80,0.00,335853.74,Non-important
270,18/01/2023,Outdoors,true,1510673238894,2705.76,0.00,333147.98,Important
271,18/01/2023,Jewelry,false,1719868556157,0.00,1420.13,334568.11,Non-Essential
272,18/01/2023,Toys,true,1880779075052,712.38,0.00,333855.73,Non-Essential
273,19/01/2023,Books,true,1942826636102,4846.13,0.00,329009.60,Non-important
274,19/01/2023,Grocery,false,1315539734331,0.00,1806.93,330816.53,Essential
275,19/01/2023,Clothing,false,1943340331860,0.00,4585.96,335402.49,Essential
276,19/01/2023,Sports,false,1965765644166,0.00,3132.37,338534.86,Important
277,19/01/2023,Electronics,false,1909840236305,0.00,2806.37,341341.23,Non-important
278,19/01/2023,Shoes,false,1222464190899,0.00,4916.12,346257.35,Non-Essential
279,19/01/2023,Sports,true,1106747320098,714.23,0.00,345543.12,Non-important
280,19/01/2023,Movies,false,1790741085799,0.00,3872.87,349415.99,Important
281,19/01/2023,Kids,true,1032101188201,2988.96,0.00,346427.03,Important
282,19/01/2023,Automotive,false,1197443730665,0.00,2458.61,348885.64,Important
283,19/01/2023,Clothing,true,1518267799054,2960.08,0.00,345925.56,Non-Essential
284,19/01/2023,Shoes,false,1488222571674,0.00,4309.55,350235.11,Non-important
285,19/01/2023,Toys,false,1555700725882,0.00,1963.84,352198.95,Non-important
286,19/01/2023,Garden,false,1905534340032,0.00,1083.06,353282.01,Non-important
287,19/01/2023,Home,true,1539516176771,658.32,0.00,352623.69,Important
288,19/01/2023,Outdoors,false,1069897487236,0.00,634.91,353258.60,Essential
289,19/01/2023,Baby,true,1316251645690,1854.84,0.00,351403.76,Important
290,20/01/2023,Automotive,false,1853604137466,0.00,2939.64,354343.40,Important
291,20/01/2023,Industrial,false,1150205534621,0.00,450.87,354794.27,Important
292,20/01/2023,Industrial,false,1386517771734,0.00,967.76,355762.03,Important
293,20/01/2023,Electronics,false,1698447777985,0.00,3651.00,359413.03,Essential
294,20/01/2023,Books,true,1309973044593,2909.11,0.00,356503.92,Non-Essential
295,20/01/2023,Books,false,1067058297888,0.00,4869.22,361373.14,Non-Essential
296,20/01/2023,Home,false,1046921388555,0.00,4856.75,366229.89,Non-important
297,20/01/2023,Sports,false,1940903147809,0.00,2172.29,368402.18,Non-Essential
298,20/01/2023,Outdoors,false,1144485055172,0.00,2750.02,371152.20,Essential
299,20/01/2023,Garden,true,1123241762129,409.58,0.00,370742.62,Important
300,20/01/2023,Jewelry,false,1680321354354,0.00,681.23,371423.85,Essential
301,20/01/2023,Books,false,1796175089622,0.00,2195.95,373619.80,Non-important
302,20/01/2023,Movies,false,1411177213349,0.00,4131.58,377751.38,Important
303,20/01/2023,Kids,false,1958660834450,0.00,4191.46,381942.84,Important
304,21/01/2023,Clothing,false,1828176468644,0.00,1462.49,383405.33,Essential
305,21/01/2023,Home,true,1681852452382,4520.34,0.00,378884.99,Important
306,21/01/2023,Tools,true,1759371353264,1868.03,0.00,377016.96,Essential
307,21/01/2023,Grocery,true,1699030490410,1904.62,0.00,375112.34,Essential
308,21/01/2023,Kids,false,1378808153335,0.00,1992.50,377104.84,Important
309,21/01/2023,Electronics,false,1088079142551,0.00,4102.70,381207.54,Non-important
310,21/01/2023,Garden,false,1720926083712,0.00,1337.16,382544.70,Essential
311,21/01/2023,Electronics,true,1514575106129,617.21,0.00,381927.49,Essential
312,21/01/2023,Games,false,1279198939587,0.00,3984.41,385911.90,Non-important
313,21/01/2023,Games,true,1594985599456,3326.57,0.00,382585.33,Essential
314,21/01/2023,Grocery,false,1062026128575,0.00,1096.72,383682.05,Non-Essential
315,21/01/2023,Kids,true,1533205971272,870.76,0.00,382811.29,Essential
316,21/01/2023,Automotive,true,1920244779256,217.86,0.00,382593.43,Non-Essential
317,21/01/2023,Grocery,false,1901803379401,0.00,2130.93,384724.36,Important
318,21/01/2023,Kids,true,1564906507582,1916.48,0.00,382807.88,Important
319,22/01/2023,Industrial,false,1053765430167,0.00,3599.76,386407.64,Essential
320,22/01/2023,Automotive,false,1374243917996,0.00,194.45,386602.09,Non-Essential
321,22/01/2023,Beauty,true,1657980096139,918.24,0.00,385683.85,Non-important
322,22/01/2023,Electronics,false,1120559723883,0.00,593.54,386277.39,Non-Essential
323,22/01/2023,Music,true,1729180591412,718.64,0.00,385558.75,Non-important
324,22/01/2023,Movies,true,1988746605565,2756.79,0.00,382801.96,Important
325,23/01/2023,Garden,false,1681675570494,0.00,2040.98,384842.94,Non-Essential
326,23/01/2023,Home,true,1540450223331,4172.11,0.00,380670.83,Non-Essential
327,23/01/2023,Beauty,false,1040384774506,0.00,3842.77,384513.60,Non-Essential
328,23/01/2023,Beauty,true,1444130184975,149.86,0.00,384363.74,Non-important
329,23/01/2023,Industrial,true,1486938034431,4195.20,0.00,380168.54,Essential
330,23/01/2023,Industrial,true,1224258698493,824.98,0.00,379343.56,Non-important
331,23/01/2023,Electronics,true,1196216076117,3953.14,0.00,375390.42,Essential
332,23/01/2023,Electronics,false,1556711873917,0.00,181.34,375571.76,Important
333,23/01/2023,Games,false,1476846730190,0.00,3047.03,378618.79,Non-Essential
334,23/01/2023,Garden,true,1197333932736,363.31,0.00,378255.48,Non-Essential
335,24/01/2023,Games,true,1440996580111,323.80,0.00,377931.68,Non-Essential
336,24/01/2023,Industrial,false,1006213154424,0.00,3419.95,381351.63,Important
337,24/01/2023,Music,true,1030260921847,4039.24,0.00,377312.39,Important
338,24/01/2023,Automotive,true,1211635575102,2799.69,0.00,374512.70,Non-Essential
339,24/01/2023,Health,false,1002337599253,0.00,4261.36,378774.06,Non-important
340,24/01/2023,Automotive,false,1943605285752,0.00,4275.57,383049.63,Essential
341,24/01/2023,Movies,true,1977843416841,1568.50,0.00,381481.13,Essential
342,24/01/2023,Industrial,false,1037947344001,0.00,2159.83,383640.96,Non-Essential
343,25/01/2023,Outdoors,true,1773068253960,3023.28,0.00,380617.68,Non-Essential
344,25/01/2023,Movies,false,1355360666931,0.00,3601.91,384219.59,Non-Essential
345,25/01/2023,Tools,false,1419850681921,0.00,1476.11,385695.70,Non-important
346,25/01/2023,Health,true,1536499700152,1255.39,0.00,384440.31,Non-important
347,25/01/2023,Grocery,true,1981677439490,2990.73,0.00,381449.58,Non-Essential
348,25/01/2023,Kids,false,1013631188645,0.00,518.23,381967.81,Non-Essential
349,25/01/2023,Garden,true,1872912072826,3855.42,0.00,378112.39,Essential
350,25/01/2023,Outdoors,false,1586152078931,0.00,205.07,378317.46,Important
351,25/01/2023,Automotive,true,1165685259547,4100.95,0.00,374216.51,Essential
352,25/01/2023,Outdoors,false,1452478821138,0.00,2699.02,376915.53,Non-Essential
353,25/01/2023,Beauty,true,1442494507807,1955.21,0.00,374960.32,Important
354,25/01/2023,Outdoors,false,1187252267109,0.00,455.80,375416.12,Essential
355,26/01/2023,Clothing,false,1839886109520,0.00,645.59,376061.71,Non-important
356,26/01/2023,Baby,false,1310534954379,0.00,3985.59,380047.30,Non-Essential
357,26/01/2023,Grocery,true,1188345870396,3474.10,0.00,376573.20,Non-Essential
358,26/01/2023,Automotive,false,1229728543378,0.00,2111.78,378684.98,Important
359,26/01/2023,Jewelry,true,1923903996531,1184.11,0.00,377500.87,Important
360,26/01/2023,Health,true,1769276565463,563.28,0.00,376937.59,Non-Essential
361,26/01/2023,Industrial,false,1962023241217,0.00,2889.53,379827.12,Essential
362,26/01/2023,Shoes,false,1771097175371,0.00,4810.45,384637.57,Non-Essential
363,26/01/2023,Garden,false,1217650517798,0.00,4255.31,388892.88,Important
364,26/01/2023,Tools,false,1427375404369,0.00,161.08,389053.96,Essential
365,26/01/2023,Electronics,true,1432059105901,4533.96,0.00,384520.00,Essential
366,27/01/2023,Health,true,1255603717286,2224.66,0.00,382295.34,Non-Essential
367,27/01/2023,Tools,true,1271052123347,1392.90,0.00,380902.44,Important
368,27/01/2023,Home,false,1981541776799,0.00,3384.43,384286.87,Important
369,27/01/2023,Baby,true,1949061726074,1453.97,0.00,382832.90,Non-important
370,27/01/2023,Games,false,1827015547582,0.00,2058.20,384891.10,Non-important
371,27/01/2023,Electronics,false,1989411297619,0.00,4642.40,389533.50,Non-important
372,27/01/2023,Clothing,true,1351258824953,3503.99,0.00,386029.51,Essential
373,27/01/2023,Home,false,1877040442554,0.00,4640.36,390669.87,Essential
374,27/01/2023,Books,false,1954646043152,0.00,1570.97,392240.84,Important
375,27/01/2023,Computers,false,1480338087486,0.00,3351.74,395592.58,Non-Essential
376,27/01/2023,Automotive,false,1129539749738,0.00,1932.09,397524.67,Non-important
377,28/01/2023,Tools,true,1078669577055,4141.06,0.00,393383.61,Non-important
378,28/01/2023,Health,false,1894058559797,0.00,4536.03,397919.64,Non-Essential
379,28/01/2023,Shoes,false,1900850975836,0.00,3537.43,401457.07,Non-important
380,28/01/2023,Books,true,1988287166590,1880.06,0.00,399577.01,Essential
381,28/01/2023,Automotive,false,1816669103276,0.00,3499.51,403076.52,Important
382,28/01/2023,Music,false,1770031707557,0.00,4990.88,408067.40,Essential
383,29/01/2023,Jewelry,false,1563959860428,0.00,679.33,408746.73,Non-Essential
384,29/01/2023,Kids,false,1211422192990,0.00,4235.27,412982.00,Essential
385,29/01/2023,Garden,false,1867030893723,0.00,1325.11,414307.11,Non-important
386,29/01/2023,Industrial,true,1219836777121,1834.04,0.00,412473.07,Essential
387,29/01/2023,Automotive,false,1728140271995,0.00,3102.42,415575.49,Non-important
388,29/01/2023,Outdoors,false,1686544436732,0.00,1083.04,416658.53,Non-Essential
389,29/01/2023,Tools,true,1841355377209,3297.56,0.00,413360.97,Important
390,29/01/2023,Automotive,false,1241147158418,0.00,3329.02,416689.99,Non-Essential
391,29/01/2023,Home,false,1501831553465,0.00,4510.59,421200.58,Non-important
392,29/01/2023,Beauty,false,1564300640105,0.00,3100.48,424301.06,Non-important
393,29/01/2023,Games,false,1096952933210,0.00,3316.42,427617.48,Non-important
394,29/01/2023,Automotive,true,1744626995641,3979.74,0.00,423637.74,Non-important
395,29/01/2023,Books,true,1977021767865,2879.62,0.00,420758.12,Essential
396,29/01/2023,Health,false,1615653697298,0.00,1405.19,422163.31,Non-important
397,30/01/2023,Industrial,true,1069943371024,4606.36,0.00,417556.95,Non-important
398,30/01/2023,Outdoors,false,1642292935616,0.00,2635.57,420192.52,Important
399,30/01/2023,Toys,true,1636449361681,2829.61,0.00,417362.91,Essential
400,30/01/2023,Grocery,true,1260964987266,4152.18,0.00,413210.73,Non-Essential
401,30/01/2023,Tools,false,1983544253683,0.00,1370.53,414581.26,Non-important
402,30/01/2023,Music,true,1967472166313,1740.29,0.00,412840.97,Important
403,30/01/2023,Tools,false,1461549829657,0.00,4781.50,417622.47,Important
404,30/01/2023,Home,false,1616855041071,0.00,4606.39,422228.86,Non-important
405,31/01/2023,Toys,false,1916221332918,0.00,4797.18,427026.04,Important
406,31/01/2023,Computers,true,1998576948360,4180.94,0.00,422845.10,Essential
407,31/01/2023,Grocery,true,1149490654028,1694.85,0.00,421150.25,Important
408,31/01/2023,Books,false,1727589790606,0.00,4562.39,425712.64,Essential
409,31/01/2023,Sports,false,1990808897998,0.00,3732.25,429444.89,Important
410,31/01/2023,Beauty,true,1757104058298,416.59,0.00,429028.30,Essential
411,31/01/2023,Sports,true,1343297815084,2503.83,0.00,426524.47,Essential
412,01/02/2023,Toys,true,1125470562249,171.95,0.00,426352.52,Important
413,01/02/2023,Music,false,1114258188775,0.00,2504.88,428857.40,Important
414,01/02/2023,Home,true,1692533389588,597.57,0.00,428259.83,Essential
415,01/02/2023,Tools,false,1769813681811,0.00,3053.65,431313.48,Important
416,01/02/2023,Automotive,true,1259108685658,2197.06,0.00,429116.42,Important
417,01/02/2023,Grocery,false,1615625104849,0.00,628.68,429745.10,Essential
418,01/02/2023,Tools,false,1472346640126,0.00,1476.77,431221.87,Essential
419,01/02/2023,Computers,true,1446720804102,3200.75,0.00,428021.12,Important
420,01/02/2023,Shoes,false,1471735708193,0.00,4390.62,432411.74,Important
421,01/02/2023,Health,true,1443763483398,2326.25,0.00,430085.49,Essential
422,02/02/2023,Kids,false,1574949919695,0.00,4383.56,434469.05,Non-Essential
423,02/02/2023,Beauty,true,1836443256409,3893.63,0.00,430575.42,Important
424,02/02/2023,Books,true,1410930446287,344.17,0.00,430231.25,Non-Essential
425,02/02/2023,Garden,true,1190472918861,1356.86,0.00,428874.39,Important
426,02/02/2023,Movies,true,1037913186181,4136.55,0.00,424737.84,Non-important
427,02/02/2023,Automotive,true,1797234733652,3639.39,0.00,421098.45,Non-Essential
428,02/02/2023,Clothing,false,1537883418150,0.00,1180.88,422279.33,Important
429,02/02/2023,Health,true,1631307725572,4441.75,0.00,417837.58,Important
430,02/02/2023,Toys,false,1428594397059,0.00,3737.70,421575.28,Non-important
431,02/02/2023,Tools,true,1113591916056,3075.62,0.00,418499.66,Essential
432,02/02/2023,Games,true,1466227065270,1418.65,0.00,417081.01,Important
433,02/02/2023,Sports,true,1116411950511,2244.48,0.00,414836.53,Non-important
434,02/02/2023,Computers,false,1283154480492,0.00,2022.82,416859.35,Non-important
435,02/02/2023,Jewelry,false,1979836872890,0.00,3211.46,420070.81,Non-Essential
436,03/02/2023,Movies,false,1656228510033,0.00,4452.73,424523.54,Essential
437,03/02/2023,Beauty,true,1346075177046,2793.44,0.00,421730.10,Non-Essential
438,03/02/2023,Movies,false,1886902703247,0.00,1499.16,423229.26,Essential
439,03/02/2023,Movies,false,1713270210629,0.00,510.13,423739.39,Essential
440,03/02/2023,Health,false,1299304809835,0.00,4827.27,428566.66,Non-Essential
441,03/02/2023,Electronics,false,1491594877679,0.00,4369.01,432935.67,Important
442,03/02/2023,Home,true,1951360186931,2664.29,0.00,430271.38,Non-important
443,03/02/2023,Toys,false,1757944726395,0.00,2013.50,432284.88,Non-important
444,03/02/2023,Outdoors,false,1145845184647,0.00,740.56,433025.44,Non-important
445,03/02/2023,Grocery,false,1581861894617,0.00,4971.89,437997.33,Non-Essential
446,03/02/2023,Clothing,false,1444459021990,0.00,3384.64,441381.97,Non-important
447,04/02/2023,Music,false,1316902193992,0.00,2464.96,443846.93,Essential
448,04/02/2023,Clothing,true,1741662371194,2082.81,0.00,441764.12,Non-important
449,04/02/2023,Kids,false,1080884251842,0.00,1221.30,442985.42,Important
450,04/02/2023,Clothing,true,1563314936632,2652.72,0.00,440332.70,Important
451,04/02/2023,Garden,true,1264936598539,3022.52,0.00,437310.18,Non-Essential
452,04/02/2023,Shoes,false,1817014434252,0.00,4202.27,441512.45,Essential
453,04/02/2023,Beauty,false,1565423823208,0.00,1366.92,442879.37,Important
454,04/02/2023,Toys,true,1375609781022,3598.71,0.00,439280.66,Important
455,04/02/2023,Outdoors,true,1124479636493,2645.68,0.00,436634.98,Important
456,04/02/2023,Clothing,false,1197424074748,0.00,3284.15,439919.13,Non-Essential
457,04/02/2023,Tools,true,1309939255616,4819.31,0.00,435099.82,Essential
458,04/02/2023,Home,false,1409908667482,0.00,2358.44,437458.26,Non-Essential
459,04/02/2023,Computers,false,1977307039596,0.00,2377.07,439835.33,Non-Essential
460,05/02/2023,Outdoors,false,1660335583528,0.00,2260.43,442095.76,Important
461,05/02/2023,Outdoors,true,1989883793477,1954.96,0.00,440140.80,Non-Essential
462,05/02/2023,Outdoors,false,1637302733800,0.00,4017.55,444158.35,Essential
463,05/02/2023,Garden,true,1489660122722,4227.86,0.00,439930.49,Non-important
464,05/02/2023,Health,true,1966660291023,1257.04,0.00,438673.45,Important
465,05/02/2023,Jewelry,false,1026259250913,0.00,1926.78,440600.23,Important
466,05/02/2023,Automotive,false,1705908708674,0.00,10.31,440610.54,Non-Essential
467,05/02/2023,Beauty,false,1637079992727,0.00,3126.99,443737.53,Important
468,05/02/2023,Baby,false,1412817526119,0.00,2466.46,446203.99,Non-Essential
469,05/02/2023,Music,true,1698569787481,1436.14,0.00,444767.85,Non-Essential
470,05/02/2023,Music,true,1652665180421,102.70,0.00,444665.15,Non-Essential
471,05/02/2023,Industrial,true,1095770083448,2078.64,0.00,442586.51,Important
472,06/02/2023,Outdoors,false,1827231630879,0.00,1689.69,444276.20,Important
473,06/02/2023,Tools,false,1161205175327,0.00,2447.55,446723.75,Non-Essential
474,06/02/2023,Baby,false,1093363348059,0.00,4440.16,451163.91,Non-important
475,06/02/2023,Tools,false,1671405390288,0.00,3022.18,454186.09,Non-Essential
476,06/02/2023,Books,true,1145764332307,4157.03,0.00,450029.06,Non-Essential
477,06/02/2023,Industrial,false,1708622676524,0.00,3609.82,453638.88,Essential
478,06/02/2023,Games,false,1547096234799,0.00,1159.53,454798.41,Non-Essential
479,06/02/2023,Music,true,1100266567234,1630.36,0.00,453168.05,Essential
480,06/02/2023,Outdoors,true,1777206848005,3250.49,0.00,449917.56,Non-important
481,06/02/2023,Garden,true,1793030808359,4042.19,0.00,445875.37,Essential
482,06/02/2023,Music,false,1030640613593,0.00,3237.51,449112.88,Non-Essential
483,06/02/2023,Shoes,false,1866840438721,0.00,3305.80,452418.68,Non-important
484,06/02/2023,Kids,true,1665514036357,3785.22,0.00,448633.46,Non-important
485,06/02/2023,Garden,true,1011942247530,4338.00,0.00,444295.46,Non-Essential
486,06/02/2023,Toys,false,1293412932950,0.00,9.94,444305.40,Non-important
487,07/02/2023,Baby,true,1854280819917,4045.36,0.00,440260.04,Important
488,07/02/2023,Games,false,1890512866509,0.00,3365.42,443625.46,Essential
489,07/02/2023,Garden,false,1843833390453,0.00,990.23,444615.69,Essential
490,07/02/2023,Music,false,1530666259951,0.00,3338.37,447954.06,Non-Essential
491,07/02/2023,Industrial,false,1518233015398,0.00,123.73,448077.79,Non-important
492,07/02/2023,Electronics,false,1618612244135,0.00,388.89,448466.68,Important
493,07/02/2023,Books,true,1420822818946,2868.49,0.00,445598.19,Essential
494,07/02/2023,Garden,true,1065149886439,645.93,0.00,444952.26,Essential
495,07/02/2023,Books,false,1013453900353,0.00,2806.99,447759.25,Non-Essential
496,07/02/2023,Grocery,true,1675674260058,861.88,0.00,446897.37,Non-Essential
497,07/02/2023,Garden,true,1726874892412,3329.00,0.00,443568.37,Essential
498,07/02/2023,Grocery,true,1308698917736,3227.14,0.00,440341.23,Important
499,07/02/2023,Electronics,true,1349420482396,117.57,0.00,440223.66,Non-Essential
500,07/02/2023,Automotive,false,1769439620867,0.00,3154.34,443378.00,Essential
501,07/02/2023,Health,false,1346197961752,0.00,3368.14,446746.14,Non-important
502,07/02/2023,Baby,true,1856209701457,2592.79,0.00,444153.35,Non-Essential
503,07/02/2023,Kids,false,1788686409284,0.00,70.63,444223.98,Non-important
504,08/02/2023,Electronics,true,1744988543021,2674.37,0.00,441549.61,Non-important
505,08/02/2023,Movies,false,1776407072832,0.00,3327.47,444877.08,Essential
506,08/02/2023,Beauty,true,1217404813815,4464.13,0.00,440412.95,Non-important
507,08/02/2023,Movies,true,1255397969068,4822.76,0.00,435590.19,Essential
508,08/02/2023,Baby,true,1445257966928,3579.28,0.00,432010.91,Important
509,08/02/2023,Clothing,true,1390138372921,727.92,0.00,431282.99,Non-important
510,08/02/2023,Health,true,1571513280814,2439.00,0.00,428843.99,Non-Essential
511,09/02/2023,Automotive,false,1063392797850,0.00,4332.76,433176.75,Important
512,09/02/2023,Toys,true,1219318189172,3199.97,0.00,429976.78,Important
513,09/02/2023,Automotive,false,1274492537425,0.00,1572.50,431549.28,Non-Essential
514,09/02/2023,Beauty,false,1616280765460,0.00,4851.35,436400.63,Important
515,09/02/2023,Kids,true,1080097548211,2730.88,0.00,433669.75,Essential
516,10/02/2023,Grocery,true,1106397365424,1458.99,0.00,432210.76,Essential
517,10/02/2023,Movies,true,1487465552573,4409.39,0.00,427801.37,Non-important
518,10/02/2023,Computers,false,1295077720368,0.00,3803.76,431605.13,Non-Essential
519,10/02/2023,Baby,false,1540105458175,0.00,2392.78,433997.91,Non-important
520,10/02/2023,Industrial,true,1443949999452,1262.50,0.00,432735.41,Essential
521,10/02/2023,Industrial,true,1028262808019,2075.39,0.00,430660.02,Non-Essential
522,10/02/2023,Music,true,1282724531800,41.98,0.00,430618.04,Important
523,10/02/2023,Jewelry,true,1718711543341,4997.75,0.00,425620.29,Non-Essential
524,10/02/2023,Sports,true,1655911059822,1418.59,0.00,424201.70,Non-important
525,10/02/2023,Computers,true,1062513507779,3765.52,0.00,420436.18,Essential
526,10/02/2023,Electronics,true,1101621895736,2737.17,0.00,417699.01,Important
527,10/02/2023,Automotive,false,1705455694033,0.00,1869.03,419568.04,Non-important
528,10/02/2023,Music,true,1504972087286,2498.37,0.00,417069.67,Non-important
529,10/02/2023,Baby,false,1706858682472,0.00,4445.98,421515.65,Non-important
530,10/02/2023,Sports,false,1005867453522,0.00,4998.67,426514.32,Non-important
531,10/02/2023,Electronics,true,1541922178385,61.80,0.00,426452.52,Essential
532,11/02/2023,Baby,true,1620543804024,894.41,0.00,425558.11,Important
533,11/02/2023,Shoes,false,1219046720496,0.00,2095.80,427653.91,Non-Essential
534,11/02/2023,Tools,false,1644676126871,0.00,1864.32,429518.23,Non-important
535,11/02/2023,Computers,false,1644745580857,0.00,2544.78,432063.01,Non-important
536,11/02/2023,Home,false,1138531017035,0.00,169.30,432232.31,Non-Essential
537,11/02/2023,Electronics,false,1794626090832,0.00,2764.22,434996.53,Important
538,11/02/2023,Music,false,1573745007870,0.00,4513.43,439509.96,Essential
539,11/02/2023,Clothing,true,1182976418599,685.84,0.00,438824.12,Important
540,11/02/2023,Kids,false,1253532798111,0.00,99.52,438923.64,Non-important
541,12/02/2023,Clothing,true,1748254749942,4036.85,0.00,434886.79,Important
542,12/02/2023,Shoes,true,1005814977405,4309.23,0.00,430577.56,Non-Essential
543,12/02/2023,Clothing,true,1489193553074,2240.37,0.00,428337.19,Non-important
544,12/02/2023,Grocery,true,1989889692453,4078.68,0.00,424258.51,Non-important
545,12/02/2023,Industrial,true,1895065401490,2119.82,0.00,422138.69,Non-important
546,12/02/2023,Sports,true,1176901433873,591.21,0.00,421547.48,Non-Essential
547,12/02/2023,Home,false,1933312860727,0.00,2647.91,424195.39,Non-Essential
548,12/02/2023,Kids,false,1666632280840,0.00,1043.04,425238.43,Non-Essential
549,12/02/2023,Tools,true,1418520556378,3411.54,0.00,421826.89,Essential
550,12/02/2023,Grocery,false,1077138790738,0.00,3603.50,425430.39,Important
551,12/02/2023,Garden,true,1350392235068,4980.00,0.00,420450.39,Non-important
552,12/02/2023,Clothing,false,1182154683149,0.00,4144.59,424594.98,Non-important
553,13/02/2023,Kids,true,1178054301602,3530.10,0.00,421064.88,Non-important
554,13/02/2023,Health,false,1618626079184,0.00,459.51,421524.39,Non-important
555,13/02/2023,Computers,true,1149882909742,78.16,0.00,421446.23,Essential
556,13/02/2023,Music,true,1721720809548,2834.53,0.00,418611.70,Non-important
557,13/02/2023,Games,false,1932229674794,0.00,281.24,418892.94,Important
558,13/02/2023,Movies,false,1913575267505,0.00,1430.54,420323.48,Important
559,13/02/2023,Games,true,1342216455547,3163.95,0.00,417159.53,Non-important
560,13/02/2023,Toys,true,1725286689088,4353.34,0.00,412806.19,Non-important
561,13/02/2023,Tools,true,1652886852387,2017.91,0.00,410788.28,Non-Essential
562,13/02/2023,Garden,false,1621592238862,0.00,4288.89,415077.17,Non-Essential
563,13/02/2023,Outdoors,true,1917536433211,2890.83,0.00,412186.34,Non-important
564,14/02/2023,Toys,false,1628885081946,0.00,2660.95,414847.29,Essential
565,14/02/2023,Books,false,1434578758325,0.00,4470.42,419317.71,Non-Essential
566,14/02/2023,Beauty,true,1944220652643,1704.51,0.00,417613.20,Essential
567,14/02/2023,Movies,true,1480710481554,4553.59,0.00,413059.61,Non-Essential
568,14/02/2023,Clothing,false,1191006829733,0.00,3438.63,416498.24,Non-Essential
569,14/02/2023,Books,true,1106550359833,941.73,0.00,415556.51,Non-Essential
570,14/02/2023,Home,true,1885195386414,4402.56,0.00,411153.95,Non-important
571,14/02/2023,Games,false,1534838516017,0.00,4399.36,415553.31,Important
572,14/02/2023,Electronics,true,1193687242376,2992.57,0.00,412560.74,Essential
573,14/02/2023,Baby,true,1659417319880,2390.25,0.00,410170.49,Non-Essential
574,14/02/2023,Shoes,true,1977262430926,4066.47,0.00,406104.02,Non-important
575,14/02/2023,Health,false,1617230307192,0.00,3490.89,409594.91,Important
576,15/02/2023,Toys,false,1193669770982,0.00,4360.55,413955.46,Essential
577,15/02/2023,Garden,false,1870094142906,0.00,4207.35,418162.81,Non-important
578,15/02/2023,Toys,true,1651154570603,3845.61,0.00,414317.20,Important
579,15/02/2023,Sports,false,1785873648175,0.00,4385.05,418702.25,Important
580,15/02/2023,Games,true,1278376602958,2375.11,0.00,416327.14,Important
581,15/02/2023,Tools,true,1987548427500,3220.42,0.00,413106.72,Non-important
582,15/02/2023,Industrial,true,1502140873948,2600.98,0.00,410505.74,Important
583,15/02/2023,Computers,true,1994317670764,354.71,0.00,410151.03,Non-Essential
584,15/02/2023,Outdoors,true,1395755217648,514.67,0.00,409636.36,Important
585,15/02/2023,Grocery,false,1220399197050,0.00,2306.48,411942.84,Non-Essential
586,15/02/2023,Clothing,false,1008558453438,0.00,3566.72,415509.56,Non-Essential
587,15/02/2023,Clothing,false,1899111740786,0.00,1153.78,416663.34,Non-important
588,15/02/2023,Automotive,false,1983610695379,0.00,3843.13,420506.47,Non-important
589,16/02/2023,Beauty,false,1061805499468,0.00,2192.55,422699.02,Non-Essential
590,16/02/2023,Automotive,false,1593988012453,0.00,2041.24,424740.26,Non-important
591,16/02/2023,Health,true,1115844691494,3131.01,0.00,421609.25,Non-important
592,16/02/2023,Computers,false,1409325267907,0.00,3517.87,425127.12,Important
593,16/02/2023,Grocery,false,1929024911192,0.00,3200.62,428327.74,Non-important
594,16/02/2023,Grocery,true,1443426309421,3274.57,0.00,425053.17,Non-important
595,16/02/2023,Computers,true,1846786414262,454.76,0.00,424598.41,Non-Essential
596,16/02/2023,Jewelry,false,1628341540046,0.00,1862.10,426460.51,Important
597,16/02/2023,Health,false,1215713296893,0.00,1050.37,427510.88,Non-important
598,16/02/2023,Beauty,false,1501086558200,0.00,825.37,428336.25,Essential
599,17/02/2023,Shoes,true,1601895971056,2198.95,0.00,426137.30,Important
600,17/02/2023,Electronics,true,1786542532966,1852.08,0.00,424285.22,Non-important
601,17/02/2023,Health,true,1482077287680,4754.03,0.00,419531.19,Important
602,17/02/2023,Beauty,true,1908892197357,1146.47,0.00,418384.72,Important
603,17/02/2023,Jewelry,true,1551467585873,173.72,0.00,418211.00,Non-Essential
604,17/02/2023,Baby,false,1811940456087,0.00,540.16,418751.16,Essential
605,17/02/2023,Computers,false,1625659848129,0.00,2306.51,421057.67,Essential
606,17/02/2023,Tools,true,1360106808895,770.41,0.00,420287.26,Important
607,18/02/2023,Computers,true,1617620725441,1972.66,0.00,418314.60,Important
608,18/02/2023,Movies,true,1307207787787,4943.94,0.00,413370.66,Essential
609,18/02/2023,Toys,false,1010624348072,0.00,3942.98,417313.64,Non-important
610,18/02/2023,Electronics,true,1199672450258,4741.43,0.00,412572.21,Non-Essential
611,18/02/2023,Sports,false,1178181385777,0.00,3334.48,415906.69,Non-Essential
612,18/02/2023,Baby,true,1172216879086,1823.26,0.00,414083.43,Essential
613,18/02/2023,Tools,false,1906218220702,0.00,3586.49,417669.92,Important
614,18/02/2023,Sports,false,1155118385147,0.00,3315.36,420985.28,Important
615,18/02/2023,Clothing,false,1593862119320,0.00,1774.57,422759.85,Important
616,19/02/2023,Tools,false,1638373599254,0.00,2341.95,425101.80,Essential
617,19/02/2023,Industrial,true,1947371443046,2820.14,0.00,422281.66,Non-Essential
618,19/02/2023,Grocery,true,1982402938287,1135.69,0.00,421145.97,Important
619,19/02/2023,Movies,false,1114938498491,0.00,4125.40,425271.37,Non-important
620,19/02/2023,Jewelry,true,1605714258507,1868.08,0.00,423403.29,Non-important
621,19/02/2023,Jewelry,true,1557722692091,2825.55,0.00,420577.74,Non-important
622,19/02/2023,Garden,false,1427254539066,0.00,3584.80,424162.54,Important
623,19/02/2023,Music,true,1716455029093,552.70,0.00,423609.84,Essential
624,19/02/2023,Baby,false,1232803570985,0.00,382.46,423992.30,Important
625,19/02/2023,Home,true,1028684285626,2144.83,0.00,421847.47,Essential
626,19/02/2023,Jewelry,false,1123077938549,0.00,2904.20,424751.67,Important
627,19/02/2023,Toys,true,1534633661450,1889.98,0.00,422861.69,Non-important
628,20/02/2023,Garden,false,1866984846787,0.00,4583.68,427445.37,Non-Essential
629,20/02/2023,Shoes,false,1892803789387,0.00,1302.95,428748.32,Non-important
630,20/02/2023,Toys,true,1071380628136,1498.80,0.00,427249.52,Non-important
631,20/02/2023,Kids,false,1181530463564,0.00,2896.23,430145.75,Essential
632,20/02/2023,Garden,true,1187732274492,4995.78,0.00,425149.97,Important
633,20/02/2023,Home,false,1268750499015,0.00,1233.38,426383.35,Essential
634,20/02/2023,Baby,true,1425222926460,1540.83,0.00,424842.52,Important
635,20/02/2023,Industrial,false,1856759028611,0.00,2482.05,427324.57,Important
636,20/02/2023,Shoes,true,1504360235091,3768.97,0.00,423555.60,Important
637,20/02/2023,Shoes,false,1935306543027,0.00,3154.79,426710.39,Essential
638,20/02/2023,Garden,false,1633550838012,0.00,950.67,427661.06,Important
639,20/02/2023,Shoes,false,1753059339194,0.00,1859.29,429520.35,Non-important
640,20/02/2023,Sports,true,1682238407818,3272.13,0.00,426248.22,Important
641,21/02/2023,Beauty,false,1648663945275,0.00,4375.43,430623.65,Non-Essential
642,21/02/2023,Beauty,true,1565234729984,4370.12,0.00,426253.53,Non-important
643,21/02/2023,Outdoors,false,1851045966064,0.00,4565.81,430819.34,Essential
644,21/02/2023,Electronics,true,1881677661830,3555.88,0.00,427263.46,Non-Essential
645,21/02/2023,Electronics,true,1953587821558,1117.16,0.00,426146.30,Essential
646,21/02/2023,Grocery,false,1789885398587,0.00,350.37,426496.67,Non-Essential
647,21/02/2023,Computers,false,1371884096840,0.00,1083.38,427580.05,Essential
648,21/02/2023,Garden,false,1666032353202,0.00,1967.17,429547.22,Non-Essential
649,22/02/2023,Books,false,1128637197729,0.00,2823.52,432370.74,Important
650,22/02/2023,Baby,true,1086811059409,3937.09,0.00,428433.65,Essential
651,22/02/2023,Sports,true,1305505232409,2453.66,0.00,425979.99,Non-important
652,22/02/2023,Toys,true,1267660826994,4113.61,0.00,421866.38,Important
653,22/02/2023,Grocery,true,1188253263493,3924.61,0.00,417941.77,Important
654,22/02/2023,Computers,false,1492107557496,0.00,687.64,418629.41,Non-important
655,22/02/2023,Tools,true,1438491209638,4427.33,0.00,414202.08,Non-Essential
656,22/02/2023,Music,true,1014119233189,2480.89,0.00,411721.19,Non-Essential
657,22/02/2023,Health,false,1914000588330,0.00,2161.80,413882.99,Non-Essential
658,22/02/2023,Health,false,1554103478891,0.00,33.18,413916.17,Important
659,22/02/2023,Clothing,true,1148827051077,894.93,0.00,413021.24,Essential
660,22/02/2023,Beauty,false,1274127331917,0.00,387.58,413408.82,Important
661,22/02/2023,Computers,true,1351379196577,3032.81,0.00,410376.01,Non-important
662,22/02/2023,Sports,true,1593626895720,2922.05,0.00,407453.96,Non-Essential
663,23/02/2023,Movies,true,1303389282819,1961.40,0.00,405492.56,Essential
664,23/02/2023,Outdoors,false,1104688275895,0.00,4404.20,409896.76,Non-important
665,23/02/2023,Music,true,1493348518569,3125.43,0.00,406771.33,Essential
666,23/02/2023,Industrial,false,1569565535634,0.00,504.66,407275.99,Non-Essential
667,23/02/2023,Shoes,true,1260036659323,1015.10,0.00,406260.89,Important
668,23/02/2023,Movies,true,1266694855297,4393.39,0.00,401867.50,Essential
669,23/02/2023,Books,true,1039635528952,1264.26,0.00,400603.24,Non-important
670,23/02/2023,Toys,true,1995050711013,1858.19,0.00,398745.05,Important
671,23/02/2023,Clothing,true,1120829522309,706.48,0.00,398038.57,Essential
672,23/02/2023,Grocery,false,1209043078862,0.00,3357.76,401396.33,Non-Essential
673,23/02/2023,Industrial,true,1279229550184,3989.02,0.00,397407.31,Essential
674,23/02/2023,Jewelry,true,1395371168633,1263.83,0.00,396143.48,Essential
675,24/02/2023,Health,true,1433833466242,767.91,0.00,395375.57,Non-important
676,24/02/2023,Clothing,false,1807527122584,0.00,1353.17,396728.74,Important
677,24/02/2023,Toys,true,1296673955247,4861.09,0.00,391867.65,Non-Essential
678,24/02/2023,Electronics,false,1945698214521,0.00,2966.65,394834.30,Important
679,24/02/2023,Grocery,false,1887139018233,0.00,2907.68,397741.98,Non-Essential
680,24/02/2023,Books,false,1381087546517,0.00,2904.10,400646.08,Important
681,24/02/2023,Beauty,false,1763995784403,0.00,4408.06,405054.14,Important
682,24/02/2023,Industrial,true,1122635939596,2984.20,0.00,402069.94,Essential
683,24/02/2023,Electronics,true,1284807223742,3548.21,0.00,398521.73,Essential
684,24/02/2023,Movies,false,1761427914548,0.00,4034.54,402556.27,Important
685,25/02/2023,Movies,true,1674793738056,3251.67,0.00,399304.60,Essential
686,25/02/2023,Home,true,1511944453053,745.19,0.00,398559.41,Essential
687,25/02/2023,Industrial,true,1749257504035,2317.57,0.00,396241.84,Essential
688,25/02/2023,Outdoors,true,1742744391561,8.81,0.00,396233.03,Important
689,25/02/2023,Home,true,1849549140637,25.46,0.00,396207.57,Non-important
690,25/02/2023,Grocery,false,1658355646511,0.00,2381.55,398589.12,Important
691,25/02/2023,Baby,false,1277046230722,0.00,1785.79,400374.91,Non-important
692,25/02/2023,Home,false,1469081565053,0.00,4053.38,404428.29,Non-Essential
693,25/02/2023,Outdoors,true,1844985922518,3721.45,0.00,400706.84,Non-important
694,25/02/2023,Industrial,true,1624253629070,4598.40,0.00,396108.44,Non-Essential
695,25/02/2023,Books,false,1222139913565,0.00,2747.85,398856.29,Non-important
696,25/02/2023,Computers,true,1470243877514,3729.28,0.00,395127.01,Essential
697,25/02/2023,Health,false,1440822011044,0.00,3037.06,398164.07,Essential
698,25/02/2023,Tools,false,1206793320992,0.00,1369.85,399533.92,Non-important
699,25/02/2023,Shoes,false,1679985373809,0.00,3357.42,402891.34,Essential
700,26/02/2023,Computers,true,1641065125595,3098.96,0.00,399792.38,Essential
701,26/02/2023,Games,true,1837433516245,162.87,0.00,399629.51,Essential
702,26/02/2023,Grocery,false,1587590581415,0.00,2739.69,402369.20,Non-important
703,26/02/2023,Toys,false,1908356641853,0.00,4954.95,407324.15,Essential
704,26/02/2023,Beauty,false,1030471886384,0.00,2099.52,409423.67,Non-Essential
705,26/02/2023,Clothing,true,1814734043929,2725.26,0.00,406698.41,Non-important
706,26/02/2023,Computers,true,1336717025227,3004.58,0.00,403693.83,Essential
707,26/02/2023,Sports,true,1827187672760,1159.65,0.00,402534.18,Essential
708,26/02/2023,Toys,true,1550879140589,3017.86,0.00,399516.32,Important
709,26/02/2023,Outdoors,false,1594840678111,0.00,425.17,399941.49,Important
710,26/02/2023,Outdoors,false,1848811936632,0.00,2619.02,402560.51,Essential
711,27/02/2023,Baby,false,1832386593212,0.00,2581.31,405141.82,Essential
712,27/02/2023,Computers,false,1727711748540,0.00,4864.05,410005.87,Essential
713,27/02/2023,Movies,true,1490001949963,3902.15,0.00,406103.72,Important
714,27/02/2023,Computers,false,1334379384972,0.00,38.83,406142.55,Non-important
715,27/02/2023,Electronics,true,1958671454539,3336.53,0.00,402806.02,Important
716,27/02/2023,Shoes,false,1276452897805,0.00,3664.36,406470.38,Non-Essential
717,27/02/2023,Beauty,true,1559236842210,1511.34,0.00,404959.04,Essential
718,27/02/2023,Outdoors,true,1872751505215,756.75,0.00,404202.29,Important
719,27/02/2023,Electronics,true,1207039945648,2914.47,0.00,401287.82,Non-important
720,28/02/2023,Garden,false,1590661665921,0.00,2348.50,403636.32,Non-Essential
721,28/02/2023,Garden,true,1937224174141,2481.34,0.00,401154.98,Non-Essential
722,28/02/2023,Shoes,false,1576070738745,0.00,705.74,401860.72,Non-important
723,28/02/2023,Games,true,1591572377362,1259.71,0.00,400601.01,Non-important
724,28/02/2023,Toys,false,1567025922386,0.00,201.41,400802.42,Essential
725,28/02/2023,Kids,false,1481244698715,0.00,1326.69,402129.11,Essential
726,28/02/2023,Health,true,1813078180016,4974.68,0.00,397154.43,Essential
727,28/02/2023,Home,true,1596430510340,1483.95,0.00,395670.48,Non-important
728,28/02/2023,Baby,true,1740122438662,1997.61,0.00,393672.87,Essential
729,28/02/2023,Garden,true,1878234568492,4938.04,0.00,388734.83,Essential
730,28/02/2023,Books,false,1366595177417,0.00,3278.28,392013.11,Important
731,28/02/2023,Grocery,true,1644907509788,1977.24,0.00,390035.87,Important
732,28/02/2023,Sports,false,1448090155322,0.00,3549.39,393585.26,Essential
733,28/02/2023,Computers,false,1776454331109,0.00,4657.45,398242.71,Non-Essential
734,28/02/2023,Outdoors,true,1106721389665,1675.19,0.00,396567.52,Non-Essential
735,01/03/2023,Electronics,true,1374047419010,3165.96,0.00,393401.56,Non-Essential
736,01/03/2023,Shoes,true,1112027218327,3881.72,0.00,389519.84,Essential
737,01/03/2023,Music,false,1229239114358,0.00,1143.87,390663.71,Non-Essential
738,01/03/2023,Tools,true,1094065001498,3222.19,0.00,387441.52,Essential
739,01/03/2023,Movies,true,1777620874711,2250.91,0.00,385190.61,Essential
740,01/03/2023,Clothing,true,1212421833235,4645.96,0.00,380544.65,Important
741,01/03/2023,Industrial,true,1127218850059,1673.43,0.00,378871.22,Essential
742,01/03/2023,Outdoors,true,1005705052080,4798.94,0.00,374072.28,Important
743,01/03/2023,Automotive,true,1004057633645,2324.35,0.00,371747.93,Important
744,01/03/2023,Clothing,false,1939610701463,0.00,647.20,372395.13,Non-Essential
745,01/03/2023,Automotive,false,1166180413858,0.00,922.25,373317.38,Non-Essential
746,01/03/2023,Sports,false,1022279362158,0.00,4051.43,377368.81,Non-Essential
747,01/03/2023,Industrial,true,1825212223089,1712.05,0.00,375656.76,Essential
748,02/03/2023,Games,false,1380999766819,0.00,4408.70,380065.46,Non-important
749,02/03/2023,Shoes,false,1228665257573,0.00,4780.61,384846.07,Non-Essential
750,02/03/2023,Industrial,false,1532765013073,0.00,4020.09,388866.16,Essential
751,02/03/2023,Tools,false,1015496645781,0.00,4200.05,393066.21,Non-Essential
752,02/03/2023,Automotive,true,1342762604543,131.25,0.00,392934.96,Non-Essential
753,02/03/2023,Baby,false,1487717810684,0.00,3945.69,396880.65,Non-important
754,02/03/2023,Garden,true,1499355645673,3151.28,0.00,393729.37,Essential
755,02/03/2023,Outdoors,false,1853260630538,0.00,2852.40,396581.77,Non-important
756,02/03/2023,Jewelry,false,1117810818118,0.00,3148.39,399730.16,Non-Essential
757,03/03/2023,Health,false,1656837104464,0.00,3937.18,403667.34,Non-important
758,03/03/2023,Computers,false,1766087023469,0.00,4515.23,408182.57,Non-Essential
759,03/03/2023,Grocery,true,1226979948821,1463.31,0.00,406719.26,Non-Essential
760,03/03/2023,Computers,false,1430033936147,0.00,992.28,407711.54,Important
761,03/03/2023,Outdoors,false,1085916716293,0.00,4461.82,412173.36,Essential
762,03/03/2023,Games,true,1231599451448,2567.13,0.00,409606.23,Important
763,03/03/2023,Sports,true,1973943367777,1135.05,0.00,408471.18,Non-important
764,03/03/2023,Shoes,false,1170165942708,0.00,4514.39,412985.57,Non-important
765,03/03/2023,Toys,true,1173364029787,335.67,0.00,412649.90,Essential
766,03/03/2023,Home,false,1421433544364,0.00,386.29,413036.19,Important
767,04/03/2023,Outdoors,true,1535339216872,1694.37,0.00,411341.82,Non-Essential
768,04/03/2023,Electronics,false,1072244107746,0.00,1390.54,412732.36,Non-Essential
769,04/03/2023,Clothing,true,1726618253263,4966.06,0.00,407766.30,Non-Essential
770,04/03/2023,Automotive,true,1535404869100,2436.44,0.00,405329.86,Essential
771,04/03/2023,Music,false,1554171420230,0.00,2444.25,407774.11,Essential
772,04/03/2023,Shoes,false,1637236889851,0.00,745.24,408519.35,Essential
773,04/03/2023,Toys,false,1380708958386,0.00,52.06,408571.41,Important
774,04/03/2023,Tools,true,1362507504614,2607.83,0.00,405963.58,Non-Essential
775,04/03/2023,Movies,true,1390061063265,4610.13,0.00,401353.45,Important
776,05/03/2023,Health,false,1473519623127,0.00,4055.13,405408.58,Essential
777,05/03/2023,Books,false,1300328929769,0.00,2060.47,407469.05,Non-important
778,05/03/2023,Tools,false,1027286692730,0.00,4364.10,411833.15,Non-important
779,05/03/2023,Clothing,false,1062637749652,0.00,1556.02,413389.17,Essential
780,05/03/2023,Music,false,1909611428881,0.00,4643.14,418032.31,Non-important
781,05/03/2023,Kids,true,1766351145324,1308.48,0.00,416723.83,Non-important
782,05/03/2023,Movies,true,1889296016075,4756.26,0.00,411967.57,Essential
783,05/03/2023,Garden,false,1164103784460,0.00,2852.21,414819.78,Non-Essential
784,05/03/2023,Music,true,1753344455912,4630.32,0.00,410189.46,Important
785,05/03/2023,Home,false,1299303614511,0.00,1133.10,411322.56,Essential
786,06/03/2023,Grocery,true,1771255814902,3907.59,0.00,407414.97,Important
787,06/03/2023,Shoes,false,1346881108094,0.00,4388.97,411803.94,Important
788,06/03/2023,Jewelry,true,1675192526000,1373.21,0.00,410430.73,Important
789,06/03/2023,Music,false,1589314123502,0.00,1600.08,412030.81,Essential
790,06/03/2023,Electronics,true,1269745753383,3866.12,0.00,408164.69,Non-important
791,06/03/2023,Grocery,true,1671211407073,3063.66,0.00,405101.03,Important
792,06/03/2023,Electronics,false,1816780715512,0.00,2284.47,407385.50,Non-important
793,06/03/2023,Outdoors,false,1220873207769,0.00,392.73,407778.23,Non-Essential
794,06/03/2023,Health,false,1680695828068,0.00,2552.24,410330.47,Important
795,06/03/2023,Baby,false,1773415475385,0.00,4722.48,415052.95,Important
796,07/03/2023,Books,true,1949473251044,3347.28,0.00,411705.67,Non-Essential
797,07/03/2023,Jewelry,false,1708017053537,0.00,1463.84,413169.51,Non-important
798,07/03/2023,Books,true,1678859014458,2093.34,0.00,411076.17,Essential
799,07/03/2023,Computers,true,1721621420821,868.84,0.00,410207.33,Non-important
800,07/03/2023,Toys,false,1955623912804,0.00,547.44,410754.77,Non-important
801,07/03/2023,Health,true,1081241277511,1723.98,0.00,409030.79,Important
802,07/03/2023,Clothing,false,1228420516587,0.00,362.84,409393.63,Important
803,07/03/2023,Kids,false,1831080679876,0.00,881.35,410274.98,Important
804,07/03/2023,Music,true,1163763122881,4384.88,0.00,405890.10,Non-important
805,08/03/2023,Music,false,1644503921131,0.00,212.09,406102.19,Non-important
806,08/03/2023,Music,true,1841379650626,3694.85,0.00,402407.34,Important
807,08/03/2023,Computers,false,1008637973643,0.00,2922.79,405330.13,Important
808,08/03/2023,Sports,false,1060770560701,0.00,4804.75,410134.88,Non-important
809,08/03/2023,Kids,false,1834864949793,0.00,3713.76,413848.64,Non-important
810,08/03/2023,Automotive,true,1502436333660,3926.77,0.00,409921.87,Important
811,08/03/2023,Tools,true,1288283382818,648.83,0.00,409273.04,Important
812,08/03/2023,Jewelry,false,1120751038562,0.00,1384.93,410657.97,Non-Essential
813,09/03/2023,Toys,false,1806674188661,0.00,2774.78,413432.75,Important
814,09/03/2023,Computers,false,1790228611334,0.00,2336.98,415769.73,Important
815,09/03/2023,Clothing,true,1491742764440,614.88,0.00,415154.85,Non-Essential
816,09/03/2023,Sports,true,1320581108405,3456.86,0.00,411697.99,Non-Essential
817,09/03/2023,Sports,true,1214994014647,844.02,0.00,410853.97,Non-Essential
818,09/03/2023,Kids,false,1695863816346,0.00,4107.73,414961.70,Essential
819,09/03/2023,Home,true,1701202507794,4677.19,0.00,410284.51,Non-important
820,09/03/2023,Home,false,1178039563796,0.00,3240.15,413524.66,Essential
821,09/03/2023,Beauty,false,1019891261173,0.00,2334.73,415859.39,Essential
822,09/03/2023,Games,false,1149351529215,0.00,4806.14,420665.53,Important
823,10/03/2023,Industrial,false,1029002541035,0.00,1770.87,422436.40,Non-Essential
824,10/03/2023,Music,true,1315649653008,4218.50,0.00,418217.90,Non-Essential
825,10/03/2023,Baby,true,1442467901080,3995.31,0.00,414222.59,Non-important
826,10/03/2023,Home,true,1368579413654,1723.73,0.00,412498.86,Non-Essential
827,10/03/2023,Beauty,false,1885852772580,0.00,3275.86,415774.72,Essential
828,10/03/2023,Kids,false,1519774674372,0.00,3080.64,418855.36,Important
829,10/03/2023,Books,true,1674606194049,2222.19,0.00,416633.17,Essential
830,10/03/2023,Jewelry,false,1930612133330,0.00,3582.55,420215.72,Essential
831,10/03/2023,Kids,false,1761522144614,0.00,2643.34,422859.06,Non-important
832,10/03/2023,Home,false,1588901833017,0.00,42.33,422901.39,Non-Essential
833,11/03/2023,Games,true,1900597126943,943.46,0.00,421957.93,Non-important
834,11/03/2023,Industrial,true,1645574770495,4107.43,0.00,417850.50,Non-Essential
835,11/03/2023,Music,true,1127727795980,1587.15,0.00,416263.35,Essential
836,11/03/2023,Computers,false,1224936651942,0.00,3318.79,419582.14,Essential
837,11/03/2023,Movies,false,1480358221374,0.00,1782.53,421364.67,Non-Essential
838,11/03/2023,Sports,false,1998751362906,0.00,100.84,421465.51,Non-Essential
839,11/03/2023,Automotive,true,1199791419681,1216.85,0.00,420248.66,Non-important
840,11/03/2023,Clothing,true,1829775123506,1183.35,0.00,419065.31,Important
841,12/03/2023,Automotive,false,1677828905394,0.00,3696.29,422761.60,Important
842,12/03/2023,Kids,false,1774149723368,0.00,2065.92,424827.52,Important
843,12/03/2023,Clothing,false,1231430640025,0.00,2887.04,427714.56,Essential
844,12/03/2023,Computers,false,1502296512196,0.00,3284.43,430998.99,Essential
845,12/03/2023,Grocery,true,1365416774716,4630.88,0.00,426368.11,Non-Essential
846,12/03/2023,Grocery,true,1817355762596,3525.51,0.00,422842.60,Non-important
847,12/03/2023,Kids,false,1719358826395,0.00,386.53,423229.13,Non-Essential
848,12/03/2023,Shoes,false,1561779096285,0.00,4982.38,428211.51,Non-Essential
849,12/03/2023,Garden,false,1275202523823,0.00,1320.05,429531.56,Non-Essential
850,12/03/2023,Kids,false,1850219245511,0.00,1473.71,431005.27,Non-Essential
851,12/03/2023,Jewelry,true,1064616505975,959.62,0.00,430045.65,Important
852,13/03/2023,Electronics,false,1830503233106,0.00,4906.85,434952.50,Non-Essential
853,13/03/2023,Electronics,true,1612967036441,2231.47,0.00,432721.03,Important
854,13/03/2023,Kids,false,1731281312696,0.00,3147.62,435868.65,Important
855,13/03/2023,Kids,false,1585253653346,0.00,108.43,435977.08,Non-important
856,13/03/2023,Baby,true,1980645130572,2915.09,0.00,433061.99,Non-important
857,13/03/2023,Jewelry,true,1425786290720,4721.61,0.00,428340.38,Important
858,13/03/2023,Automotive,true,1049210944900,2968.44,0.00,425371.94,Important
859,13/03/2023,Electronics,true,1384736026620,2645.32,0.00,422726.62,Essential
860,13/03/2023,Health,false,1006894940512,0.00,1465.20,424191.82,Non-important
861,14/03/2023,Outdoors,true,1603712519864,3001.60,0.00,421190.22,Non-important
862,14/03/2023,Industrial,true,1421601150602,3082.33,0.00,418107.89,Non-Essential
863,14/03/2023,Books,false,1275422608735,0.00,2164.49,420272.38,Important
864,14/03/2023,Clothing,false,1350559335392,0.00,1520.91,421793.29,Important
865,14/03/2023,Tools,false,1209940397167,0.00,1752.73,423546.02,Non-Essential
866,14/03/2023,Movies,false,1336651593773,0.00,781.50,424327.52,Important
867,14/03/2023,Automotive,true,1889759370679,3564.22,0.00,420763.30,Non-important
868,14/03/2023,Garden,true,1128955551958,1752.33,0.00,419010.97,Non-Essential
869,14/03/2023,Automotive,false,1530779596331,0.00,1158.54,420169.51,Non-Essential
870,14/03/2023,Industrial,true,1759549335278,2475.69,0.00,417693.82,Non-important
871,14/03/2023,Outdoors,false,1566070118422,0.00,3120.24,420814.06,Important
872,14/03/2023,Outdoors,false,1341820502501,0.00,1543.35,422357.41,Essential
873,14/03/2023,Books,false,1757357190614,0.00,4681.64,427039.05,Important
874,14/03/2023,Electronics,false,1184239944104,0.00,2141.18,429180.23,Non-Essential
875,14/03/2023,Automotive,true,1652966748799,1070.70,0.00,428109.53,Important
876,14/03/2023,Shoes,false,1303135008041,0.00,2921.60,431031.13,Important
877,14/03/2023,Movies,true,1622263787652,2956.03,0.00,428075.10,Non-Essential
878,15/03/2023,Shoes,false,1057293429695,0.00,2067.46,430142.56,Essential
879,15/03/2023,Sports,true,1789386235132,716.52,0.00,429426.04,Non-important
880,15/03/2023,Electronics,true,1858656297833,1487.92,0.00,427938.12,Non-Essential
881,15/03/2023,Baby,false,1140461896097,0.00,2903.71,430841.83,Important
882,15/03/2023,Garden,false,1122953386702,0.00,2796.29,433638.12,Essential
883,15/03/2023,Music,true,1364314063166,2536.82,0.00,431101.30,Important
884,15/03/2023,Books,false,1872147941200,0.00,4784.89,435886.19,Important
885,15/03/2023,Jewelry,true,1185061282243,786.85,0.00,435099.34,Essential
886,15/03/2023,Industrial,true,1994434287380,2980.82,0.00,432118.52,Essential
887,15/03/2023,Grocery,false,1857576131439,0.00,4365.80,436484.32,Important
888,15/03/2023,Toys,true,1995419083614,986.99,0.00,435497.33,Essential
889,15/03/2023,Industrial,false,1607202539764,0.00,3380.04,438877.37,Non-Essential
890,15/03/2023,Industrial,true,1798345282965,1648.97,0.00,437228.40,Non-important
891,15/03/2023,Home,false,1484118145589,0.00,3311.79,440540.19,Essential
892,15/03/2023,Movies,false,1763364476446,0.00,4717.50,445257.69,Non-Essential
893,16/03/2023,Kids,true,1847679156439,742.44,0.00,444515.25,Non-Essential
894,16/03/2023,Baby,false,1976952526541,0.00,1076.77,445592.02,Non-Essential
895,16/03/2023,Music,true,1933670123391,1278.11,0.00,444313.91,Non-important
896,16/03/2023,Shoes,true,1880521661293,4196.36,0.00,440117.55,Important
897,16/03/2023,Outdoors,false,1047933291566,0.00,3418.33,443535.88,Essential
898,16/03/2023,Baby,false,1444715332538,0.00,4154.22,447690.10,Non-important
899,16/03/2023,Electronics,false,1844755778616,0.00,1584.76,449274.86,Essential
900,16/03/2023,Music,false,1809938417506,0.00,2147.53,451422.39,Non-important
901,16/03/2023,Grocery,true,1551023239673,4089.02,0.00,447333.37,Essential
902,16/03/2023,Movies,true,1199226680477,2071.03,0.00,445262.34,Non-Essential
903,16/03/2023,Books,true,1274774726316,2557.71,0.00,442704.63,Non-Essential
904,16/03/2023,Toys,false,1739145098382,0.00,3906.55,446611.18,Important
905,17/03/2023,Automotive,true,1381070879468,1301.15,0.00,445310.03,Essential
906,17/03/2023,Books,false,1205289515201,0.00,2546.77,447856.80,Essential
907,17/03/2023,Garden,true,1348977445683,4731.60,0.00,443125.20,Important
908,17/03/2023,Shoes,true,1527974316022,1975.99,0.00,441149.21,Important
909,17/03/2023,Kids,false,1379062542240,0.00,2000.52,443149.73,Important
910,17/03/2023,Baby,true,1599944415046,171.19,0.00,442978.54,Non-Essential
911,17/03/2023,Baby,true,1573255711418,1185.36,0.00,441793.18,Important
912,17/03/2023,Movies,false,1554935523296,0.00,1786.49,443579.67,Important
913,17/03/2023,Industrial,false,1120465372432,0.00,2413.00,445992.67,Essential
914,17/03/2023,Health,true,1526564927426,1536.64,0.00,444456.03,Essential
915,18/03/2023,Outdoors,true,1913774363341,3865.54,0.00,440590.49,Essential
916,18/03/2023,Electronics,true,1257407841397,1647.24,0.00,438943.25,Non-important
917,18/03/2023,Toys,false,1920981390374,0.00,2231.98,441175.23,Non-important
918,18/03/2023,Tools,true,1126663220713,2289.97,0.00,438885.26,Non-important
919,18/03/2023,Jewelry,true,1657703062764,4645.80,0.00,434239.46,Non-Essential
920,18/03/2023,Toys,true,1838671357209,2136.54,0.00,432102.92,Non-Essential
921,18/03/2023,Electronics,true,1212116826282,3135.87,0.00,428967.05,Non-important
922,18/03/2023,Jewelry,true,1181672247021,2970.46,0.00,425996.59,Non-Essential
923,18/03/2023,Home,false,1670055218767,0.00,3214.46,429211.05,Non-important
924,18/03/2023,Baby,false,1626829190498,0.00,864.74,430075.79,Non-important
925,19/03/2023,Toys,false,1653547296981,0.00,841.21,430917.00,Essential
926,19/03/2023,Books,true,1492501766957,1444.93,0.00,429472.07,Essential
927,19/03/2023,Computers,true,1615666997116,458.36,0.00,429013.71,Non-Essential
928,19/03/2023,Beauty,true,1087829189054,3508.50,0.00,425505.21,Non-important
929,19/03/2023,Books,true,1707165124439,2900.81,0.00,422604.40,Important
930,19/03/2023,Beauty,true,1944172968393,3233.39,0.00,419371.01,Important
931,19/03/2023,Health,false,1626718886885,0.00,3129.25,422500.26,Essential
932,19/03/2023,Jewelry,false,1237662943801,0.00,9.40,422509.66,Non-important
933,19/03/2023,Sports,false,1826398486725,0.00,3414.32,425923.98,Non-important
934,19/03/2023,Games,true,1906617869448,3651.09,0.00,422272.89,Non-Essential
935,19/03/2023,Music,false,1507558506018,0.00,1067.76,423340.65,Essential
936,19/03/2023,Shoes,false,1241358639742,0.00,1476.93,424817.58,Non-Essential
937,19/03/2023,Clothing,false,1447946946487,0.00,3714.90,428532.48,Non-Essential
938,19/03/2023,Garden,true,1590642716621,257.70,0.00,428274.78,Non-important
939,20/03/2023,Sports,true,1730799428317,2990.39,0.00,425284.39,Essential
940,20/03/2023,Baby,true,1637962889448,3936.86,0.00,421347.53,Non-important
941,20/03/2023,Outdoors,false,1429823545603,0.00,3492.99,424840.52,Important
942,20/03/2023,Toys,false,1342065889201,0.00,2491.85,427332.37,Essential
943,20/03/2023,Industrial,false,1180887023390,0.00,2466.58,429798.95,Essential
944,20/03/2023,Sports,true,1423667198953,4630.80,0.00,425168.15,Non-important
945,20/03/2023,Sports,false,1297089097194,0.00,3683.47,428851.62,Essential
946,20/03/2023,Health,false,1682801240111,0.00,316.94,429168.56,Non-important
947,21/03/2023,Grocery,true,1147898932287,2304.97,0.00,426863.59,Non-Essential
948,21/03/2023,Grocery,true,1022796347531,1492.00,0.00,425371.59,Essential
949,21/03/2023,Tools,false,1139583131209,0.00,3226.05,428597.64,Important
950,21/03/2023,Toys,true,1138627095349,4701.44,0.00,423896.20,Essential
951,21/03/2023,Toys,false,1161656589051,0.00,4427.12,428323.32,Non-Essential
952,21/03/2023,Clothing,true,1335848058843,2136.85,0.00,426186.47,Important
953,21/03/2023,Books,false,1552424670940,0.00,756.60,426943.07,Essential
954,21/03/2023,Games,false,1770408761855,0.00,2842.87,429785.94,Non-important
955,21/03/2023,Baby,false,1071242911317,0.00,950.20,430736.14,Essential
956,21/03/2023,Garden,true,1381661297861,1524.97,0.00,429211.17,Essential
957,21/03/2023,Garden,false,1792133260871,0.00,621.08,429832.25,Non-Essential
958,21/03/2023,Kids,false,1493681583130,0.00,4622.82,434455.07,Non-important
959,22/03/2023,Health,false,1518881381046,0.00,1443.58,435898.65,Non-important
960,22/03/2023,Movies,true,1679145416972,4090.62,0.00,431808.03,Non-important
961,22/03/2023,Sports,false,1346101789559,0.00,992.24,432800.27,Essential
962,22/03/2023,Garden,true,1357196450321,2425.50,0.00,430374.77,Important
963,22/03/2023,Industrial,true,1139357105140,2260.56,0.00,428114.21,Essential
964,22/03/2023,Garden,true,1633643165772,639.73,0.00,427474.48,Essential
965,22/03/2023,Games,true,1559719493583,3030.23,0.00,424444.25,Essential
966,22/03/2023,Jewelry,false,1311827011613,0.00,1924.52,426368.77,Non-important
967,22/03/2023,Jewelry,true,1464908181835,3004.09,0.00,423364.68,Non-important
968,23/03/2023,Beauty,false,1303840694188,0.00,4301.20,427665.88,Important
969,23/03/2023,Home,true,1127655698258,3748.73,0.00,423917.15,Non-Essential
970,23/03/2023,Toys,false,1400101981226,0.00,4180.85,428098.00,Essential
971,23/03/2023,Toys,true,1067540367738,912.39,0.00,427185.61,Non-Essential
972,23/03/2023,Garden,false,1929273850400,0.00,3705.75,430891.36,Non-Essential
973,23/03/2023,Games,false,1651626139231,0.00,4338.51,435229.87,Non-important
974,23/03/2023,Movies,true,1921561310833,2756.59,0.00,432473.28,Important
975,23/03/2023,Clothing,true,1115885426858,4506.62,0.00,427966.66,Non-Essential
976,23/03/2023,Baby,true,1934106846510,3601.29,0.00,424365.37,Non-important
977,23/03/2023,Grocery,false,1596094898986,0.00,3083.24,427448.61,Non-Essential
978,23/03/2023,Movies,false,1457217968339,0.00,4616.47,432065.08,Non-important
979,23/03/2023,Home,true,1833564491382,2089.35,0.00,429975.73,Non-important
980,23/03/2023,Books,true,1772310626802,926.18,0.00,429049.55,Important
981,23/03/2023,Beauty,true,1174960774489,311.53,0.00,428738.02,Non-important
982,23/03/2023,Baby,true,1248777715674,4268.41,0.00,424469.61,Important
983,23/03/2023,Games,false,1637201447560,0.00,2564.42,427034.03,Important
984,23/03/2023,Music,false,1539262875919,0.00,4995.88,432029.91,Non-Essential
985,23/03/2023,Baby,true,1389612763116,1585.00,0.00,430444.91,Essential
986,23/03/2023,Music,true,1938876533555,131.97,0.00,430312.94,Non-important
987,23/03/2023,Health,false,1113878418769,0.00,441.28,430754.22,Non-Essential
988,23/03/2023,Movies,true,1182199366818,1071.75,0.00,429682.47,Non-Essential
989,24/03/2023,Toys,false,1165796633461,0.00,4022.85,433705.32,Essential
990,24/03/2023,Garden,false,1639344010641,0.00,1017.32,434722.64,Important
991,24/03/2023,Grocery,true,1261439933863,4046.90,0.00,430675.74,Non-important
992,24/03/2023,Toys,false,1516111446345,0.00,2211.02,432886.76,Important
993,24/03/2023,Tools,false,1065409869215,0.00,511.67,433398.43,Essential
994,24/03/2023,Health,false,1454388201224,0.00,897.51,434295.94,Non-Essential
995,24/03/2023,Computers,true,1925279743432,4187.30,0.00,430108.64,Non-important
996,24/03/2023,Automotive,true,1383760846113,3989.50,0.00,426119.14,Essential
997,24/03/2023,Automotive,false,1687810536590,0.00,1487.00,427606.14,Non-important
998,24/03/2023,Books,false,1777952452267,0.00,4530.56,432136.70,Important
999,24/03/2023,Garden,true,1013777706410,3998.85,0.00,428137.85,Non-important
1000,24/03/2023,Sports,false,1080334692591,0.00,1528.40,429666.25,Important
