row,Txn Date,Description,Transfer To/From,Ref No./Cheque No.,Debit,Credit,Balance,Class
1,23/12/2022,Baby,true,4670421416617,1124.39,0.00,243044.54,Non-Essential
2,23/12/2022,Home,true,4142389275287,406.29,0.00,242638.25,Essential
3,23/12/2022,Home,false,4873015274314,0.00,1041.08,243679.33,Important
4,23/12/2022,Games,true,4694949599252,2577.05,0.00,241102.28,Non-important
5,23/12/2022,Health,false,4678644250023,0.00,1628.76,242731.04,Non-important
6,23/12/2022,Industrial,false,4365009395388,0.00,123.18,242854.22,Essential
7,23/12/2022,Toys,false,4363456679962,0.00,1438.55,244292.77,Non-important
8,23/12/2022,Jewelry,true,4637765546020,2814.58,0.00,241478.19,Important
9,23/12/2022,Tools,true,4109830301820,1181.78,0.00,240296.41,Essential
10,23/12/2022,Jewelry,true,4809505440023,576.95,0.00,239719.46,Important
11,23/12/2022,Electronics,false,4293792381835,0.00,788.69,240508.15,Essential
12,24/12/2022,Games,false,4937437324221,0.00,1420.94,241929.09,Essential
13,24/12/2022,Garden,false,4457891946069,0.00,2947.88,244876.97,Essential
14,24/12/2022,Movies,true,4769565638067,32.31,0.00,244844.66,Non-Essential
15,24/12/2022,Home,true,4355063513530,1776.27,0.00,243068.39,Non-Essential
16,24/12/2022,Baby,true,4611599897576,1179.91,0.00,241888.48,Non-important
17,24/12/2022,Games,false,4228003507515,0.00,157.45,242045.93,Non-important
18,24/12/2022,Kids,false,4212136528515,0.00,1706.31,243752.24,Non-important
19,24/12/2022,Health,true,4894964738255,1303.02,0.00,242449.22,Important
20,24/12/2022,Outdoors,true,4256242123894,1363.11,0.00,241086.11,Important
21,24/12/2022,Health,true,4382269416675,1747.70,0.00,239338.41,Non-important
22,24/12/2022,Garden,false,4712422304028,0.00,2612.35,241950.76,Essential
23,24/12/2022,Toys,false,4786925864907,0.00,80.62,242031.38,Essential
24,24/12/2022,Electronics,false,4902075093563,0.00,993.96,243025.34,Important
25,24/12/2022,Automotive,true,4249172458985,705.66,0.00,242319.68,Non-important
26,25/12/2022,Kids,false,4713955915740,0.00,1821.73,244141.41,Essential
27,25/12/2022,Books,true,4193249354900,387.60,0.00,243753.81,Non-Essential
28,25/12/2022,Kids,true,4664964198832,1728.91,0.00,242024.90,Non-Essential
29,25/12/2022,Garden,true,4022660721360,64.96,0.00,241959.94,Essential
30,25/12/2022,Sports,true,4775617260095,700.39,0.00,241259.55,Non-important
31,25/12/2022,Books,false,4292020508739,0.00,1498.63,242758.18,Essential
32,25/12/2022,Shoes,false,4916462860307,0.00,2451.64,245209.82,Important
33,25/12/2022,Industrial,true,4858779723602,2856.88,0.00,242352.94,Non-important
34,25/12/2022,Books,true,4984604102702,1824.51,0.00,240528.43,Essential
35,25/12/2022,Music,true,4732215358475,183.42,0.00,240345.01,Essential
36,26/12/2022,Grocery,true,4141772694815,2405.64,0.00,237939.37,Essential
37,26/12/2022,Automotive,false,4602710866398,0.00,1539.38,239478.75,Essential
38,26/12/2022,Home,true,4656195281424,2483.30,0.00,236995.45,Essential
39,26/12/2022,Garden,true,4351360247159,2682.03,0.00,234313.42,Essential
40,26/12/2022,Home,false,4364105001574,0.00,2827.52,237140.94,Non-important
41,26/12/2022,Toys,true,4837668001879,479.56,0.00,236661.38,Non-important
42,26/12/2022,Movies,false,4636508643895,0.00,149.28,236810.66,Non-Essential
43,26/12/2022,Games,false,4951662833181,0.00,995.47,237806.13,Non-Essential
44,26/12/2022,Jewelry,true,4514323925049,2350.82,0.00,235455.31,Non-important
45,26/12/2022,Baby,false,4352322088534,0.00,1472.03,236927.34,Important
46,26/12/2022,Outdoors,false,4723386145003,0.00,1606.81,238534.15,Important
47,26/12/2022,Grocery,false,4521767140935,0.00,663.16,239197.31,Non-important
48,26/12/2022,Movies,false,4662109829822,0.00,1074.91,240272.22,Non-Essential
49,27/12/2022,Music,true,4665368443166,2972.43,0.00,237299.79,Important
50,27/12/2022,Kids,true,4300704088375,140.86,0.00,237158.93,Essential
51,27/12/2022,Tools,false,4755802916627,0.00,1518.08,238677.01,Non-important
52,27/12/2022,Books,true,4340384857806,1443.43,0.00,237233.58,Important
53,28/12/2022,Kids,false,4428611940966,0.00,28.36,237261.94,Non-important
54,28/12/2022,Music,false,4187047664006,0.00,712.22,237974.16,Non-important
55,28/12/2022,Garden,true,4829118652967,568.75,0.00,237405.41,Non-important
56,28/12/2022,Baby,true,4954847872650,1698.39,0.00,235707.02,Non-Essential
57,28/12/2022,Games,true,4377153859309,70.99,0.00,235636.03,Non-important
58,28/12/2022,Shoes,false,4862937354142,0.00,1089.82,236725.85,Non-Essential
59,28/12/2022,Grocery,false,4761239665266,0.00,2574.75,239300.60,Non-Essential
60,28/12/2022,Garden,false,4267412922234,0.00,112.79,239413.39,Essential
61,28/12/2022,Clothing,true,4969553908083,2889.16,0.00,236524.23,Essential
62,29/12/2022,Toys,true,4976447575723,2663.23,0.00,233861.00,Non-Essential
63,29/12/2022,Music,false,4778606874487,0.00,1233.42,235094.42,Essential
64,29/12/2022,Beauty,false,4252974545232,0.00,1091.65,236186.07,Important
65,29/12/2022,Computers,true,4895236008283,844.93,0.00,235341.14,Non-important
66,29/12/2022,Toys,false,4138080853552,0.00,2289.32,237630.46,Non-important
67,29/12/2022,Toys,false,4307960459712,0.00,1662.13,239292.59,Non-Essential
68,29/12/2022,Sports,false,4659458697865,0.00,1622.84,240915.43,Essential
69,30/12/2022,Music,false,4839190753491,0.00,943.35,241858.78,Important
70,30/12/2022,Garden,true,4028846444788,2602.06,0.00,239256.72,Important
71,30/12/2022,Electronics,false,4378087798569,0.00,2028.92,241285.64,Essential
72,31/12/2022,Health,true,4566296490429,2689.14,0.00,238596.50,Essential
73,31/12/2022,Industrial,false,4457498587774,0.00,591.56,239188.06,Non-important
74,31/12/2022,Garden,true,4815199148265,2303.79,0.00,236884.27,Non-Essential
75,31/12/2022,Health,true,4063420200877,626.98,0.00,236257.29,Non-important
76,31/12/2022,Home,true,4367333803036,2183.16,0.00,234074.13,Non-Essential
77,31/12/2022,Automotive,true,4676944825654,2428.24,0.00,231645.89,Non-important
78,31/12/2022,Baby,true,4805270600031,245.50,0.00,231400.39,Important
79,31/12/2022,Sports,false,4217913045440,0.00,2483.47,233883.86,Non-Essential
80,31/12/2022,Kids,true,4272875290929,1399.46,0.00,232484.40,Essential
81,31/12/2022,Computers,false,4801233701579,0.00,1842.90,234327.30,Non-important
82,31/12/2022,Music,true,4252058197827,1069.88,0.00,233257.42,Non-Essential
83,31/12/2022,Baby,true,4064883698128,2991.25,0.00,230266.17,Important
84,31/12/2022,Health,false,4505202809794,0.00,1337.78,231603.95,Essential
85,31/12/2022,Clothing,false,4771099713687,0.00,2823.25,234427.20,Essential
86,01/01/2023,Computers,true,4451367772428,838.77,0.00,233588.43,Non-Essential
87,01/01/2023,Books,false,4609086859438,0.00,1525.79,235114.22,Non-Essential
88,01/01/2023,Grocery,true,4676069635728,812.12,0.00,234302.10,Important
89,01/01/2023,Outdoors,false,4343609341078,0.00,479.33,234781.43,Non-important
90,01/01/2023,Baby,true,4237815886528,1997.54,0.00,232783.89,Essential
91,01/01/2023,Health,true,4295233556019,1776.51,0.00,231007.38,Non-important
92,01/01/2023,Movies,true,4773320302238,1099.00,0.00,229908.38,Essential
93,02/01/2023,Computers,true,4473028825523,2985.08,0.00,226923.30,Essential
94,02/01/2023,Home,true,4503140667720,798.34,0.00,226124.96,Non-Essential
95,02/01/2023,Books,false,4728009337867,0.00,2024.72,228149.68,Non-important
96,02/01/2023,Shoes,true,4022773478841,9.00,0.00,228140.68,Important
97,02/01/2023,Tools,false,4740116662809,0.00,1274.49,229415.17,Important
98,02/01/2023,Industrial,false,4665764817822,0.00,1136.49,230551.66,Non-important
99,02/01/2023,Movies,true,4072695375156,726.12,0.00,229825.54,Non-important
100,02/01/2023,Industrial,false,4576412886389,0.00,502.58,230328.12,Non-Essential
101,02/01/2023,Garden,false,4828745854310,0.00,2159.83,232487.95,Important
102,02/01/2023,Shoes,false,4951838583917,0.00,631.58,233119.53,Non-important
103,02/01/2023,Grocery,false,4128521788034,0.00,1608.10,234727.63,Important
104,02/01/2023,Home,true,4292540434916,1121.09,0.00,233606.54,Non-Essential
105,02/01/2023,Garden,false,4304288399287,0.00,973.09,234579.63,Essential
106,03/01/2023,Music,true,4947010714421,2159.24,0.00,232420.39,Non-important
107,03/01/2023,Outdoors,false,4077330755846,0.00,588.24,233008.63,Important
108,03/01/2023,Grocery,false,4317314059648,0.00,2509.39,235518.02,Non-important
109,03/01/2023,Home,true,4566691368898,2306.80,0.00,233211.22,Essential
110,03/01/2023,Movies,false,4507244283994,0.00,1367.95,234579.17,Non-Essential
111,03/01/2023,Garden,true,4468672870505,1111.71,0.00,233467.46,Non-Essential
112,03/01/2023,Toys,true,4798022299050,1330.55,0.00,232136.91,Non-Essential
113,03/01/2023,Games,false,4996503234946,0.00,2416.93,234553.84,Important
114,03/01/2023,Shoes,false,4483019376460,0.00,2608.30,237162.14,Non-Essential
115,03/01/2023,Tools,true,4899838202783,545.52,0.00,236616.62,Essential
116,04/01/2023,Games,false,4455118002219,0.00,2462.62,239079.24,Non-important
117,04/01/2023,Games,false,4980907547380,0.00,479.05,239558.29,Essential
118,04/01/2023,Books,true,4085179813001,2910.87,0.00,236647.42,Essential
119,04/01/2023,Industrial,false,4032927668314,0.00,916.26,237563.68,Non-important
120,04/01/2023,Grocery,true,4471224719254,2739.93,0.00,234823.75,Essential
121,04/01/2023,Games,true,4366305464776,2669.86,0.00,232153.89,Non-important
122,04/01/2023,Sports,true,4036561056336,2411.39,0.00,229742.50,Non-important
123,04/01/2023,Movies,true,4554719118496,268.80,0.00,229473.70,Non-Essential
124,05/01/2023,Outdoors,true,4533779487214,47.35,0.00,229426.35,Non-Essential
125,05/01/2023,Baby,true,4540850720948,1296.97,0.00,228129.38,Essential
126,05/01/2023,Tools,false,4751064105174,0.00,277.24,228406.62,Essential
127,05/01/2023,Clothing,false,4457314477739,0.00,2016.00,230422.62,Essential
128,05/01/2023,Tools,false,4254051097193,0.00,1862.79,232285.41,Non-important
129,05/01/2023,Sports,true,4999249563132,2502.15,0.00,229783.26,Non-important
130,05/01/2023,Baby,false,4329067614801,0.00,1280.37,231063.63,Non-Essential
131,05/01/2023,Automotive,true,4872755986691,1419.65,0.00,229643.98,Non-important
132,06/01/2023,Shoes,true,4139622499458,961.85,0.00,228682.13,Non-important
133,06/01/2023,Toys,false,4317887639488,0.00,120.34,228802.47,Non-Essential
134,06/01/2023,Outdoors,true,4961636508039,2258.24,0.00,226544.23,Important
135,06/01/2023,Music,false,4030393031441,0.00,410.42,226954.65,Essential
136,06/01/2023,Grocery,true,4311248281923,1183.15,0.00,225771.50,Non-important
137,06/01/2023,Outdoors,false,4420477851533,0.00,1585.47,227356.97,Essential
138,06/01/2023,Home,true,4312511882802,971.28,0.00,226385.69,Non-Essential
139,06/01/2023,Health,true,4943477257673,975.74,0.00,225409.95,Non-important
140,06/01/2023,Beauty,false,4550239343061,0.00,452.86,225862.81,Non-Essential
141,07/01/2023,Baby,false,4372688760186,0.00,1276.83,227139.64,Essential
142,07/01/2023,Games,true,4350123038536,414.68,0.00,226724.96,Non-important
143,07/01/2023,Electronics,false,4647191230638,0.00,1815.21,228540.17,Essential
144,07/01/2023,Automotive,false,4310979651970,0.00,888.40,229428.57,Non-Essential
145,07/01/2023,Clothing,true,4662149078038,2323.66,0.00,227104.91,Non-important
146,07/01/2023,Movies,false,4246457399813,0.00,2415.65,229520.56,Non-Essential
147,07/01/2023,Games,false,4670151608113,0.00,701.88,230222.44,Essential
148,07/01/2023,Books,true,4051306291879,561.02,0.00,229661.42,Essential
149,07/01/2023,Sports,true,4130156391660,2423.84,0.00,227237.58,Non-Essential
150,08/01/2023,Jewelry,true,4016005202113,1983.46,0.00,225254.12,Essential
151,08/01/2023,Garden,true,4563037604395,2797.57,0.00,222456.55,Essential
152,08/01/2023,Beauty,false,4350586723105,0.00,2218.98,224675.53,Important
153,08/01/2023,Computers,true,4214671116136,2768.01,0.00,221907.52,Essential
154,08/01/2023,Shoes,true,4900075381977,296.90,0.00,221610.62,Non-Essential
155,08/01/2023,Sports,true,4099671558303,91.16,0.00,221519.46,Non-important
156,08/01/2023,Clothing,true,4625985786417,823.22,0.00,220696.24,Non-Essential
157,08/01/2023,Grocery,false,4230187372209,0.00,2489.07,223185.31,Non-Essential
158,09/01/2023,Movies,true,4906313998383,1738.97,0.00,221446.34,Non-Essential
159,09/01/2023,Home,false,4991122682733,0.00,1223.50,222669.84,Non-Essential
160,09/01/2023,Tools,true,4374364699872,456.46,0.00,222213.38,Non-Essential
161,09/01/2023,Home,false,4494488870231,0.00,566.11,222779.49,Non-important
162,09/01/2023,Sports,true,4150748307409,2508.75,0.00,220270.74,Essential
163,09/01/2023,Shoes,false,4888691798894,0.00,2129.35,222400.09,Non-Essential
164,09/01/2023,Toys,false,4020721954398,0.00,2933.20,225333.29,Important
165,09/01/2023,Clothing,false,4621611956755,0.00,2482.88,227816.17,Non-important
166,09/01/2023,Industrial,false,4275267900503,0.00,1486.18,229302.35,Essential
167,10/01/2023,Sports,true,4833811432255,1271.51,0.00,228030.84,Essential
168,10/01/2023,Tools,true,4876880032343,269.01,0.00,227761.83,Important
169,10/01/2023,Jewelry,true,4865677371038,517.62,0.00,227244.21,Important
170,10/01/2023,Sports,false,4273764486823,0.00,2132.45,229376.66,Non-Essential
171,10/01/2023,Baby,false,4442448349125,0.00,2567.14,231943.80,Non-Essential
172,10/01/2023,Beauty,true,4822135668918,1208.29,0.00,230735.51,Essential
173,10/01/2023,Computers,false,4894644110024,0.00,816.26,231551.77,Non-important
174,10/01/2023,Movies,true,4571562005663,2441.12,0.00,229110.65,Important
175,10/01/2023,Beauty,false,4611787956987,0.00,388.47,229499.12,Essential
176,10/01/2023,Movies,false,4323322077855,0.00,777.45,230276.57,Essential
177,11/01/2023,Movies,false,4453817222277,0.00,2250.15,232526.72,Non-Essential
178,11/01/2023,Automotive,false,4276468841042,0.00,2752.08,235278.80,Essential
179,11/01/2023,Kids,true,4194936596207,1271.69,0.00,234007.11,Important
180,11/01/2023,Tools,false,4150592956851,0.00,131.05,234138.16,Non-Essential
181,11/01/2023,Games,false,4054884313853,0.00,875.14,235013.30,Important
182,11/01/2023,Sports,false,4197053777978,0.00,2344.97,237358.27,Non-Essential
183,11/01/2023,Industrial,false,4390117391641,0.00,141.80,237500.07,Essential
184,11/01/2023,Outdoors,false,4683882057279,0.00,1837.39,239337.46,Non-Essential
185,11/01/2023,Health,true,4051658986523,1991.70,0.00,237345.76,Essential
186,12/01/2023,Electronics,true,4233140696196,2633.27,0.00,234712.49,Important
187,12/01/2023,Sports,true,4307040411081,680.76,0.00,234031.73,Essential
188,12/01/2023,Games,false,4166266547978,0.00,490.44,234522.17,Non-Essential
189,12/01/2023,Outdoors,false,4146652110330,0.00,826.05,235348.22,Non-important
190,12/01/2023,Garden,true,4509229701675,2254.49,0.00,233093.73,Non-Essential
191,12/01/2023,Health,false,4859804231267,0.00,1839.30,234933.03,Essential
192,12/01/2023,Toys,false,4561983386029,0.00,1776.72,236709.75,Non-Essential
193,12/01/2023,Kids,false,4905601563884,0.00,1901.50,238611.25,Important
194,12/01/2023,Computers,false,4570200011680,0.00,1300.37,239911.62,Non-important
195,12/01/2023,Automotive,false,4461192280704,0.00,2675.30,242586.92,Non-important
196,12/01/2023,Grocery,false,4428990206590,0.00,76.28,242663.20,Non-Essential
197,13/01/2023,Books,false,4624118745515,0.00,2067.76,244730.96,Non-important
198,13/01/2023,Health,true,4185445790002,510.51,0.00,244220.45,Important
199,13/01/2023,Industrial,true,4690808555631,2903.75,0.00,241316.70,Essential
200,13/01/2023,Automotive,false,4360214599976,0.00,2872.00,244188.70,Non-Essential
201,13/01/2023,Industrial,true,4514057676093,381.05,0.00,243807.65,Non-Essential
202,13/01/2023,Beauty,false,4893153869732,0.00,2679.50,246487.15,Important
203,13/01/2023,Kids,false,4597938196987,0.00,2093.95,248581.10,Non-important
204,13/01/2023,Tools,true,4420783978948,1815.42,0.00,246765.68,Essential
205,13/01/2023,Tools,false,4617470736078,0.00,2395.87,249161.55,Non-Essential
206,13/01/2023,Industrial,false,4590898090541,0.00,1218.03,250379.58,Non-important
207,13/01/2023,Industrial,false,4312133934124,0.00,781.74,251161.32,Non-important
208,13/01/2023,Tools,true,4200089060214,388.39,0.00,250772.93,Non-important
209,13/01/2023,Jewelry,true,4146863202185,553.07,0.00,250219.86,Non-important
210,13/01/2023,Automotive,false,4411947261803,0.00,654.47,250874.33,Important
211,14/01/2023,Beauty,false,4511828250489,0.00,2176.45,253050.78,Non-Essential
212,14/01/2023,Movies,false,4087631732112,0.00,2204.11,255254.89,Non-Essential
213,14/01/2023,Computers,true,4515001095899,482.66,0.00,254772.23,Non-Essential
214,14/01/2023,Tools,false,4840217043257,0.00,2493.59,257265.82,Non-important
215,14/01/2023,Garden,true,4069912607222,872.67,0.00,256393.15,Essential
216,14/01/2023,Jewelry,true,4767914465555,2225.67,0.00,254167.48,Non-Essential
217,14/01/2023,Clothing,true,4888478224916,1813.50,0.00,252353.98,Essential
218,14/01/2023,Beauty,true,4076371862683,2134.21,0.00,250219.77,Essential
219,14/01/2023,Games,true,4419250986471,1000.95,0.00,249218.82,Essential
220,14/01/2023,Books,true,4669642123239,2039.28,0.00,247179.54,Essential
221,14/01/2023,Garden,true,4654171602643,2925.88,0.00,244253.66,Non-important
222,14/01/2023,Outdoors,true,4640111654323,891.37,0.00,243362.29,Non-important
223,14/01/2023,Kids,true,4213106691939,1942.23,0.00,241420.06,Essential
224,14/01/2023,Grocery,false,4993134333627,0.00,1448.07,242868.13,Non-important
225,15/01/2023,Music,false,4486334903701,0.00,2897.97,245766.10,Essential
226,15/01/2023,Electronics,false,4062851153037,0.00,1826.60,247592.70,Non-important
227,15/01/2023,Sports,true,4074239919400,87.67,0.00,247505.03,Important
228,15/01/2023,Automotive,false,4900883947820,0.00,1163.35,248668.38,Essential
229,15/01/2023,Garden,false,4674871307883,0.00,2845.74,251514.12,Non-Essential
230,15/01/2023,Health,true,4400847972302,561.81,0.00,250952.31,Non-important
231,15/01/2023,Jewelry,false,4479746609020,0.00,2864.70,253817.01,Important
232,15/01/2023,Automotive,false,4273943233041,0.00,39.12,253856.13,Important
233,15/01/2023,Health,false,4934957318330,0.00,1338.46,255194.59,Non-important
234,15/01/2023,Automotive,true,4518360442163,1638.64,0.00,253555.95,Important
235,15/01/2023,Sports,false,4250569010537,0.00,1533.94,255089.89,Non-important
236,16/01/2023,Home,false,4262247479620,0.00,811.54,255901.43,Essential
237,16/01/2023,Jewelry,false,4556138709729,0.00,201.90,256103.33,Important
238,16/01/2023,Tools,true,4100668744793,744.54,0.00,255358.79,Important
239,16/01/2023,Tools,false,4872461185804,0.00,2208.13,257566.92,Non-Essential
240,16/01/2023,Books,false,4352189518658,0.00,1245.37,258812.29,Non-Essential
241,16/01/2023,Books,true,4962514683376,1362.78,0.00,257449.51,Non-Essential
242,16/01/2023,Computers,false,4654206177572,0.00,2643.26,260092.77,Essential
243,16/01/2023,Kids,false,4762272735769,0.00,169.05,260261.82,Non-Essential
244,16/01/2023,Grocery,true,4515806173350,1236.54,0.00,259025.28,Essential
245,16/01/2023,Sports,false,4137998533562,0.00,2091.58,261116.86,Essential
246,16/01/2023,Garden,true,4306015089272,2494.14,0.00,258622.72,Essential
247,16/01/2023,Outdoors,false,4792231599793,0.00,1329.07,259951.79,Important
248,16/01/2023,Games,true,4113459544892,2258.67,0.00,257693.12,Important
249,16/01/2023,Automotive,false,4758397183702,0.00,1528.28,259221.40,Non-important
250,16/01/2023,Health,false,4741479987272,0.00,1408.57,260629.97,Important
251,16/01/2023,Music,true,4483368063626,430.04,0.00,260199.93,Important
252,16/01/2023,Games,true,4544361570612,1451.35,0.00,258748.58,Essential
253,16/01/2023,Beauty,false,4471771126779,0.00,2278.23,261026.81,Non-important
254,16/01/2023,Baby,false,4229168300370,0.00,2268.01,263294.82,Non-Essential
255,17/01/2023,Tools,true,4923819657295,97.40,0.00,263197.42,Important
256,17/01/2023,Jewelry,true,4416905488179,85.75,0.00,263111.67,Essential
257,17/01/2023,Garden,false,4195141604302,0.00,236.07,263347.74,Important
258,17/01/2023,Toys,true,4771731930189,1708.92,0.00,261638.82,Important
259,17/01/2023,Grocery,false,4722498818864,0.00,2025.23,263664.05,Non-important
260,17/01/2023,Outdoors,true,4736532226510,209.44,0.00,263454.61,Non-Essential
261,17/01/2023,Automotive,true,4746159155517,297.34,0.00,263157.27,Non-important
262,17/01/2023,Home,false,4713798483140,0.00,2634.59,265791.86,Essential
263,17/01/2023,Shoes,false,4036103904957,0.00,1994.67,267786.53,Non-Essential
264,17/01/2023,Toys,true,4539548630438,1867.34,0.00,265919.19,Important
265,17/01/2023,Industrial,false,4629408733774,0.00,1667.00,267586.19,Non-important
266,18/01/2023,Shoes,true,4186526276220,2036.26,0.00,265549.93,Non-important
267,18/01/2023,Industrial,true,4623269656906,138.54,0.00,265411.39,Essential
268,18/01/2023,Jewelry,false,4717722542602,0.00,333.37,265744.76,Non-Essential
269,18/01/2023,Shoes,false,4010365528057,0.00,1562.08,267306.84,Essential
270,18/01/2023,Grocery,false,4569767042467,0.00,533.78,267840.62,Non-important
271,18/01/2023,Outdoors,true,4983727244550,19.38,0.00,267821.24,Essential
272,18/01/2023,Baby,true,4383404560037,2406.52,0.00,265414.72,Non-important
273,18/01/2023,Outdoors,true,4924282668783,342.87,0.00,265071.85,Important
274,18/01/2023,Jewelry,false,4447132225999,0.00,703.16,265775.01,Non-important
275,18/01/2023,Shoes,false,4202207600624,0.00,1465.26,267240.27,Non-Essential
276,18/01/2023,Home,false,4163411267749,0.00,2428.58,269668.85,Essential
277,18/01/2023,Toys,false,4414858904600,0.00,1124.37,270793.22,Non-Essential
278,18/01/2023,Jewelry,true,4965210354470,2455.51,0.00,268337.71,Non-important
279,19/01/2023,Movies,true,4207139762637,2106.14,0.00,266231.57,Important
280,19/01/2023,Games,true,4772320899450,972.52,0.00,265259.05,Non-Essential
281,19/01/2023,Health,false,4012298818599,0.00,2820.46,268079.51,Non-important
282,19/01/2023,Outdoors,false,4863974487055,0.00,1793.88,269873.39,Non-important
283,19/01/2023,Automotive,false,4753339040648,0.00,427.94,270301.33,Important
284,19/01/2023,Books,true,4010651489740,1472.17,0.00,268829.16,Essential
285,19/01/2023,Grocery,false,4049577022812,0.00,2416.17,271245.33,Non-important
286,19/01/2023,Beauty,false,4563831600858,0.00,1050.95,272296.28,Non-important
287,19/01/2023,Toys,true,4280587048927,2113.31,0.00,270182.97,Non-Essential
288,19/01/2023,Jewelry,false,4896752935386,0.00,2754.60,272937.57,Non-important
289,19/01/2023,Clothing,false,4607048686732,0.00,2616.19,275553.76,Non-important
290,19/01/2023,Music,false,4125916457187,0.00,2306.17,277859.93,Non-important
291,20/01/2023,Books,false,4006276426832,0.00,546.89,278406.82,Essential
292,20/01/2023,Toys,false,4844933640879,0.00,1619.33,280026.15,Non-Essential
293,20/01/2023,Computers,false,4327641839817,0.00,2388.79,282414.94,Non-important
294,20/01/2023,Computers,true,4604802174917,1491.11,0.00,280923.83,Essential
295,20/01/2023,Tools,false,4707060706643,0.00,1921.56,282845.39,Non-Essential
296,20/01/2023,Shoes,true,4533376582626,2497.02,0.00,280348.37,Important
297,20/01/2023,Clothing,false,4496308247927,0.00,2293.68,282642.05,Non-important
298,20/01/2023,Outdoors,true,4329996860857,921.33,0.00,281720.72,Important
299,20/01/2023,Electronics,true,4998290225286,2074.70,0.00,279646.02,Non-important
300,20/01/2023,Tools,false,4380501600267,0.00,1626.39,281272.41,Non-important
301,20/01/2023,Tools,true,4733567136561,154.43,0.00,281117.98,Non-Essential
302,21/01/2023,Movies,false,4154900408044,0.00,2947.31,284065.29,Important
303,21/01/2023,Tools,false,4463877066361,0.00,1747.44,285812.73,Non-Essential
304,21/01/2023,Movies,true,4851582623620,1746.32,0.00,284066.41,Non-Essential
305,21/01/2023,Tools,false,4886143449571,0.00,2720.91,286787.32,Non-important
306,21/01/2023,Tools,false,4241393481543,0.00,1651.25,288438.57,Non-Essential
307,21/01/2023,Grocery,true,4274323017160,2303.62,0.00,286134.95,Important
308,21/01/2023,Home,false,4330049544005,0.00,2898.46,289033.41,Essential
309,21/01/2023,Games,true,4201555370695,194.29,0.00,288839.12,Non-important
310,21/01/2023,Tools,true,4005354782041,1994.66,0.00,286844.46,Important
311,22/01/2023,Toys,true,4790801087783,2095.00,0.00,284749.46,Important
312,22/01/2023,Sports,false,4403773279177,0.00,196.80,284946.26,Non-Essential
313,22/01/2023,Games,true,4488051990263,2704.81,0.00,282241.45,Important
314,22/01/2023,Kids,false,4446391966970,0.00,139.17,282380.62,Essential
315,22/01/2023,Electronics,false,4671171290321,0.00,219.24,282599.86,Non-important
316,22/01/2023,Books,true,4742654785368,824.39,0.00,281775.47,Important
317,22/01/2023,Electronics,true,4500728439001,2332.63,0.00,279442.84,Non-important
318,23/01/2023,Books,false,4798649613787,0.00,805.46,280248.30,Non-important
319,23/01/2023,Beauty,false,4706973389977,0.00,660.68,280908.98,Essential
320,23/01/2023,Grocery,false,4115971913297,0.00,2871.68,283780.66,Important
321,23/01/2023,Computers,false,4691584278886,0.00,2480.76,286261.42,Non-Essential
322,23/01/2023,Books,false,4334416687473,0.00,1843.21,288104.63,Essential
323,23/01/2023,Outdoors,true,4777643552528,646.62,0.00,287458.01,Important
324,23/01/2023,Computers,false,4311481980262,0.00,2978.08,290436.09,Non-important
325,23/01/2023,Outdoors,false,4334906003776,0.00,1875.69,292311.78,Non-Essential
326,23/01/2023,Music,false,4036230558721,0.00,153.92,292465.70,Essential
327,23/01/2023,Health,true,4116849952369,2958.73,0.00,289506.97,Important
328,23/01/2023,Toys,true,4617426314071,2880.25,0.00,286626.72,Important
329,23/01/2023,Tools,false,4644910720879,0.00,2923.59,289550.31,Non-Essential
330,23/01/2023,Automotive,false,4207913577546,0.00,329.69,289880.00,Non-important
331,23/01/2023,Electronics,true,4089597760347,1436.35,0.00,288443.65,Essential
332,23/01/2023,Sports,true,4610539637423,2799.39,0.00,285644.26,Non-important
333,23/01/2023,Outdoors,false,4953124810627,0.00,1604.52,287248.78,Important
334,23/01/2023,Home,true,4149581570351,148.30,0.00,287100.48,Non-Essential
335,23/01/2023,Books,false,4233912699846,0.00,1896.44,288996.92,Essential
336,23/01/2023,Industrial,false,4177907933902,0.00,1392.24,290389.16,Important
337,23/01/2023,Games,true,4657543302546,275.19,0.00,290113.97,Non-Essential
338,24/01/2023,Home,true,4536119625923,56.56,0.00,290057.41,Non-Essential
339,24/01/2023,Games,true,4394480005436,2039.20,0.00,288018.21,Non-important
340,24/01/2023,Outdoors,false,4008544511281,0.00,990.20,289008.41,Non-Essential
341,24/01/2023,Home,true,4456576084467,1710.18,0.00,287298.23,Important
342,24/01/2023,Baby,true,4630907826422,2312.02,0.00,284986.21,Essential
343,24/01/2023,Beauty,true,4128710135975,1757.38,0.00,283228.83,Non-Essential
344,24/01/2023,Garden,false,4853130976802,0.00,225.13,283453.96,Non-Essential
345,24/01/2023,Beauty,true,4859432777222,2328.88,0.00,281125.08,Essential
346,24/01/2023,Games,false,4320809794297,0.00,2634.31,283759.39,Non-Essential
347,24/01/2023,Health,false,4068385700525,0.00,2751.26,286510.65,Non-important
348,24/01/2023,Tools,false,4910482459287,0.00,1803.95,288314.60,Non-important
349,24/01/2023,Grocery,false,4652486387718,0.00,2853.88,291168.48,Essential
350,24/01/2023,Industrial,false,4339311390960,0.00,1566.74,292735.22,Essential
351,25/01/2023,Kids,true,4803774375134,891.82,0.00,291843.40,Important
352,25/01/2023,Games,true,4180056783191,1038.93,0.00,290804.47,Non-important
353,25/01/2023,Garden,false,4385993708935,0.00,1025.81,291830.28,Non-important
354,25/01/2023,Electronics,false,4304057637200,0.00,1012.04,292842.32,Non-important
355,25/01/2023,Kids,false,4478113079309,0.00,2848.40,295690.72,Non-important
356,25/01/2023,Music,false,4086353729074,0.00,2105.11,297795.83,Non-important
357,25/01/2023,Computers,false,4365953430486,0.00,1450.66,299246.49,Essential
358,25/01/2023,Music,false,4373441812720,0.00,609.67,299856.16,Essential
359,25/01/2023,Garden,true,4575032459428,2923.41,0.00,296932.75,Essential
360,25/01/2023,Shoes,true,4868260842802,2303.76,0.00,294628.99,Non-important
361,25/01/2023,Beauty,true,4184960839039,1286.80,0.00,293342.19,Important
362,25/01/2023,Baby,true,4159398476471,580.60,0.00,292761.59,Non-Essential
363,26/01/2023,Baby,false,4088175465052,0.00,925.72,293687.31,Essential
364,26/01/2023,Grocery,true,4476819054487,1197.43,0.00,292489.88,Non-Essential
365,26/01/2023,Games,false,4142173131165,0.00,2186.42,294676.30,Non-important
366,26/01/2023,Tools,true,4221486047334,2768.67,0.00,291907.63,Essential
367,26/01/2023,Grocery,true,4571189718858,851.62,0.00,291056.01,Essential
368,26/01/2023,Automotive,true,4256657981371,230.34,0.00,290825.67,Non-important
369,26/01/2023,Electronics,false,4210328380777,0.00,534.81,291360.48,Non-Essential
370,26/01/2023,Electronics,false,4828689213628,0.00,845.40,292205.88,Non-important
371,26/01/2023,Grocery,true,4148722856089,1425.59,0.00,290780.29,Non-Essential
372,26/01/2023,Industrial,true,4336267408406,132.35,0.00,290647.94,Important
373,27/01/2023,Home,false,4891931509338,0.00,382.79,291030.73,Important
374,27/01/2023,Games,false,4966470347785,0.00,2218.39,293249.12,Non-Essential
375,27/01/2023,Books,false,4410529370157,0.00,162.69,293411.81,Non-Essential
376,27/01/2023,Books,true,4338736397016,19.64,0.00,293392.17,Non-Essential
377,27/01/2023,Tools,false,4268473533027,0.00,2305.49,295697.66,Essential
378,27/01/2023,Games,false,4387873986055,0.00,1171.49,296869.15,Important
379,27/01/2023,Grocery,true,4825576086236,1461.52,0.00,295407.63,Essential
380,27/01/2023,Music,false,4898354424862,0.00,1822.94,297230.57,Essential
381,27/01/2023,Tools,false,4862619055926,0.00,365.93,297596.50,Non-Essential
382,27/01/2023,Kids,true,4418246868006,955.24,0.00,296641.26,Non-Essential
383,27/01/2023,Grocery,true,4997549565043,732.48,0.00,295908.78,Essential
384,28/01/2023,Music,false,4445834211723,0.00,718.51,296627.29,Non-Essential
385,28/01/2023,Home,true,4312487557306,1794.65,0.00,294832.64,Non-important
386,28/01/2023,Outdoors,false,4857047559721,0.00,1958.65,296791.29,Non-important
387,28/01/2023,Automotive,false,4754582359706,0.00,2223.56,299014.85,Essential
388,28/01/2023,Shoes,true,4250024993450,1455.99,0.00,297558.86,Non-Essential
389,28/01/2023,Outdoors,true,4771965960545,252.85,0.00,297306.01,Non-important
390,28/01/2023,Toys,false,4011966430458,0.00,98.87,297404.88,Non-Essential
391,28/01/2023,Sports,false,4360265006895,0.00,2061.06,299465.94,Important
392,28/01/2023,Home,true,4234240271924,1517.09,0.00,297948.85,Non-Essential
393,28/01/2023,Electronics,false,4308849568171,0.00,482.47,298431.32,Important
394,28/01/2023,Games,false,4386123199820,0.00,2756.63,301187.95,Important
395,28/01/2023,Automotive,false,4336783233310,0.00,817.36,302005.31,Important
396,28/01/2023,Clothing,true,4390310279782,400.63,0.00,301604.68,Non-Essential
397,28/01/2023,Music,true,4328527846466,2460.91,0.00,299143.77,Important
398,28/01/2023,Music,true,4748623118729,1538.35,0.00,297605.42,Non-Essential
399,29/01/2023,Baby,true,4602558756486,1426.82,0.00,296178.60,Important
400,29/01/2023,Home,true,4932564496973,173.47,0.00,296005.13,Important
401,29/01/2023,Automotive,true,4061305702544,1466.82,0.00,294538.31,Important
402,29/01/2023,Automotive,false,4226655741803,0.00,492.47,295030.78,Important
403,29/01/2023,Music,false,4260665726372,0.00,2743.27,297774.05,Non-important
404,29/01/2023,Music,true,4905606592291,611.39,0.00,297162.66,Important
405,29/01/2023,Books,false,4498058876981,0.00,686.28,297848.94,Essential
406,29/01/2023,Sports,true,4095148104203,744.79,0.00,297104.15,Essential
407,29/01/2023,Outdoors,false,4143475796753,0.00,287.74,297391.89,Non-important
408,29/01/2023,Tools,true,4092537440057,1291.61,0.00,296100.28,Important
409,29/01/2023,Computers,true,4882944984637,2918.11,0.00,293182.17,Important
410,29/01/2023,Computers,false,4244811774623,0.00,1212.45,294394.62,Non-Essential
411,29/01/2023,Home,true,4110656117261,462.91,0.00,293931.71,Non-Essential
412,30/01/2023,Garden,true,4497705312257,1499.17,0.00,292432.54,Non-Essential
413,30/01/2023,Jewelry,true,4044657630919,540.35,0.00,291892.19,Essential
414,30/01/2023,Electronics,false,4647689482250,0.00,1978.87,293871.06,Non-Essential
415,30/01/2023,Books,true,4772405328100,2994.97,0.00,290876.09,Essential
416,30/01/2023,Tools,true,4843852362089,836.07,0.00,290040.02,Essential
417,30/01/2023,Automotive,true,4138858414395,1667.27,0.00,288372.75,Non-important
418,31/01/2023,Shoes,false,4439396937779,0.00,2918.69,291291.44,Non-important
419,31/01/2023,Garden,false,4192866045669,0.00,2054.09,293345.53,Non-Essential
420,31/01/2023,Home,false,4395977821864,0.00,107.74,293453.27,Essential
421,31/01/2023,Jewelry,true,4139770388729,2589.93,0.00,290863.34,Essential
422,31/01/2023,Health,false,4572817345081,0.00,760.53,291623.87,Non-Essential
423,31/01/2023,Sports,false,4650342412080,0.00,884.07,292507.94,Important
424,31/01/2023,Games,true,4180617065159,625.90,0.00,291882.04,Non-Essential
425,31/01/2023,Outdoors,false,4862814597205,0.00,2353.25,294235.29,Non-Essential
426,01/02/2023,Movies,true,4571972671736,1518.65,0.00,292716.64,Non-Essential
427,01/02/2023,Books,true,4631080827673,2191.39,0.00,290525.25,Non-important
428,01/02/2023,Health,false,4987070061527,0.00,1812.19,292337.44,Essential
429,01/02/2023,Grocery,true,4910999496793,1638.72,0.00,290698.72,Non-important
430,01/02/2023,Outdoors,false,4102772211974,0.00,77.49,290776.21,Essential
431,01/02/2023,Tools,false,4839716159823,0.00,2492.99,293269.20,Non-important
432,01/02/2023,Beauty,false,4289881183146,0.00,369.76,293638.96,Essential
433,01/02/2023,Electronics,true,4729398679362,2205.85,0.00,291433.11,Important
434,02/02/2023,Clothing,false,4304377639911,0.00,2128.52,293561.63,Non-important
435,02/02/2023,Beauty,true,4074050999535,231.31,0.00,293330.32,Non-important
436,02/02/2023,Computers,true,4858454084968,825.12,0.00,292505.20,Important
437,02/02/2023,Garden,false,4992001055340,0.00,491.34,292996.54,Important
438,02/02/2023,Outdoors,false,4910866925394,0.00,1863.45,294859.99,Non-important
439,02/02/2023,Shoes,true,4150827145271,106.49,0.00,294753.50,Important
440,02/02/2023,Health,true,4835381639175,1114.93,0.00,293638.57,Non-important
441,02/02/2023,Movies,false,4068153412423,0.00,205.76,293844.33,Non-Essential
442,02/02/2023,Music,false,4927435560705,0.00,2330.38,296174.71,Important
443,02/02/2023,Kids,false,4560920810639,0.00,1212.96,297387.67,Non-Essential
444,02/02/2023,Shoes,true,4066702839646,1377.55,0.00,296010.12,Essential
445,02/02/2023,Electronics,false,4099546139349,0.00,2509.23,298519.35,Essential
446,02/02/2023,Books,false,4005238685694,0.00,2577.66,301097.01,Important
447,03/02/2023,Kids,false,4716941214908,0.00,1570.46,302667.47,Non-important
448,03/02/2023,Clothing,false,4727584028592,0.00,2670.15,305337.62,Important
449,03/02/2023,Grocery,true,4516984797424,2498.24,0.00,302839.38,Non-important
450,03/02/2023,Music,true,4294128433553,1517.01,0.00,301322.37,Non-Essential
451,03/02/2023,Clothing,true,4251546446152,1716.27,0.00,299606.10,Essential
452,03/02/2023,Clothing,false,4946699626705,0.00,2512.18,302118.28,Non-Essential
453,03/02/2023,Grocery,true,4039863546361,2360.68,0.00,299757.60,Non-important
454,04/02/2023,Garden,true,4117699636370,597.03,0.00,299160.57,Non-Essential
455,04/02/2023,Outdoors,false,4968284601724,0.00,720.47,299881.04,Essential
456,04/02/2023,Music,true,4162671237987,1773.41,0.00,298107.63,Non-Essential
457,04/02/2023,Grocery,true,4645948572035,2035.56,0.00,296072.07,Non-important
458,04/02/2023,Games,false,4455298313718,0.00,782.31,296854.38,Non-important
459,04/02/2023,Home,false,4979108070237,0.00,2027.76,298882.14,Non-Essential
460,04/02/2023,Music,false,4289049115615,0.00,521.14,299403.28,Non-Essential
461,04/02/2023,Kids,true,4809868122734,558.63,0.00,298844.65,Non-Essential
462,04/02/2023,Home,true,4291391651934,1886.96,0.00,296957.69,Non-important
463,05/02/2023,Music,true,4135069527237,1916.55,0.00,295041.14,Essential
464,05/02/2023,Industrial,false,4453076093986,0.00,1416.01,296457.15,Essential
465,05/02/2023,Games,false,4685786700841,0.00,686.42,297143.57,Essential
466,05/02/2023,Toys,false,4707885324005,0.00,2862.71,300006.28,Non-Essential
467,05/02/2023,Garden,true,4712826505541,1954.75,0.00,298051.53,Essential
468,05/02/2023,Home,true,4412637417059,837.26,0.00,297214.27,Essential
469,05/02/2023,Kids,true,4448067385865,855.01,0.00,296359.26,Essential
470,05/02/2023,Shoes,true,4983738950312,894.77,0.00,295464.49,Non-Essential
471,05/02/2023,Kids,true,4381172179085,130.15,0.00,295334.34,Essential
472,06/02/2023,Electronics,false,4347450093052,0.00,2244.80,297579.14,Non-important
473,06/02/2023,Tools,false,4806024405574,0.00,603.11,298182.25,Important
474,06/02/2023,Movies,true,4528600902797,971.74,0.00,297210.51,Important
475,06/02/2023,Health,false,4523803544646,0.00,677.05,297887.56,Important
476,06/02/2023,Grocery,false,4432580640893,0.00,1094.06,298981.62,Non-important
477,06/02/2023,Baby,true,4965083262777,1833.78,0.00,297147.84,Non-Essential
478,06/02/2023,Tools,true,4490047551340,1458.71,0.00,295689.13,Non-important
479,06/02/2023,Toys,true,4159418853773,144.08,0.00,295545.05,Non-Essential
480,06/02/2023,Baby,true,4348274164093,963.43,0.00,294581.62,Non-Essential
481,06/02/2023,Electronics,false,4573900713232,0.00,2252.26,296833.88,Non-important
482,06/02/2023,Books,false,4919805945065,0.00,185.23,297019.11,Essential
483,06/02/2023,Outdoors,true,4192779206285,1564.27,0.00,295454.84,Important
484,06/02/2023,Automotive,false,4212757904764,0.00,2175.02,297629.86,Non-important
485,07/02/2023,Computers,false,4382870385307,0.00,1566.14,299196.00,Essential
486,07/02/2023,Tools,false,4512976518090,0.00,2434.57,301630.57,Non-Essential
487,07/02/2023,Computers,false,4467358569404,0.00,1315.07,302945.64,Important
488,07/02/2023,Jewelry,false,4572224260939,0.00,2180.57,305126.21,Non-important
489,07/02/2023,Toys,true,4453289335748,1289.57,0.00,303836.64,Important
490,07/02/2023,Jewelry,true,4111601411271,2312.57,0.00,301524.07,Essential
491,08/02/2023,Beauty,false,4385315607332,0.00,650.32,302174.39,Non-Essential
492,08/02/2023,Baby,true,4922571371458,33.96,0.00,302140.43,Non-Essential
493,08/02/2023,Baby,true,4188210244360,454.34,0.00,301686.09,Essential
494,08/02/2023,Health,true,4211170937976,2542.07,0.00,299144.02,Essential
495,08/02/2023,Sports,false,4231195876085,0.00,1604.28,300748.30,Important
496,08/02/2023,Outdoors,false,4625315786835,0.00,1735.68,302483.98,Important
497,08/02/2023,Baby,true,4827091386349,1519.02,0.00,300964.96,Non-Essential
498,08/02/2023,Beauty,true,4820315156333,1590.78,0.00,299374.18,Important
499,08/02/2023,Computers,true,4536279176395,2201.17,0.00,297173.01,Important
500,08/02/2023,Computers,false,4293050768086,0.00,344.29,297517.30,Non-Essential
501,08/02/2023,Beauty,false,4757325016233,0.00,2241.92,299759.22,Essential
502,08/02/2023,Clothing,false,4723060432382,0.00,2397.80,302157.02,Non-Essential
503,08/02/2023,Toys,true,4327819270998,2910.87,0.00,299246.15,Essential
504,08/02/2023,Toys,false,4323550788760,0.00,1201.97,300448.12,Non-important
505,08/02/2023,Jewelry,true,4235217149879,1668.53,0.00,298779.59,Essential
506,08/02/2023,Baby,true,4715061869665,2518.30,0.00,296261.29,Essential
507,08/02/2023,Automotive,false,4729549121195,0.00,1358.04,297619.33,Non-important
508,08/02/2023,Beauty,false,4560679327781,0.00,1102.58,298721.91,Non-Essential
509,08/02/2023,Health,false,4006438778737,0.00,1878.41,300600.32,Non-important
510,09/02/2023,Tools,false,4538553549803,0.00,2991.86,303592.18,Important
511,09/02/2023,Books,true,4093216402905,1350.17,0.00,302242.01,Non-important
512,09/02/2023,Tools,false,4448378555076,0.00,220.22,302462.23,Non-Essential
513,09/02/2023,Tools,false,4434986967595,0.00,1725.74,304187.97,Non-Essential
514,09/02/2023,Automotive,true,4464878891631,1154.95,0.00,303033.02,Essential
515,09/02/2023,Music,false,4502939769888,0.00,264.78,303297.80,Important
516,09/02/2023,Home,false,4000529503175,0.00,368.66,303666.46,Non-Essential
517,09/02/2023,Movies,false,4338776482173,0.00,1831.52,305497.98,Essential
518,09/02/2023,Music,false,4187088353354,0.00,1720.09,307218.07,Non-important
519,10/02/2023,Clothing,false,4627028987683,0.00,1064.14,308282.21,Important
520,10/02/2023,Outdoors,false,4918202960075,0.00,965.03,309247.24,Essential
521,10/02/2023,Industrial,false,4304041833861,0.00,1202.59,310449.83,Non-important
522,10/02/2023,Shoes,false,4950344137682,0.00,37.43,310487.26,Essential
523,10/02/2023,Baby,false,4299810745104,0.00,314.28,310801.54,Non-important
524,10/02/2023,Games,false,4200120643091,0.00,1073.87,311875.41,Important
525,10/02/2023,Toys,false,4498636372427,0.00,1807.02,313682.43,Important
526,11/02/2023,Games,false,4814475151031,0.00,1854.19,315536.62,Important
527,11/02/2023,Electronics,true,4251140156775,2891.05,0.00,312645.57,Non-important
528,11/02/2023,Garden,false,4665619019933,0.00,2687.27,315332.84,Essential
529,11/02/2023,Home,true,4698754229237,45.74,0.00,315287.10,Essential
530,11/02/2023,Shoes,false,4240150234849,0.00,2852.21,318139.31,Non-Essential
531,11/02/2023,Music,true,4787296700394,859.34,0.00,317279.97,Important
532,11/02/2023,Beauty,true,4292500749733,2268.65,0.00,315011.32,Non-important
533,11/02/2023,Home,false,4585659815995,0.00,1994.34,317005.66,Non-important
534,11/02/2023,Outdoors,false,4215266904543,0.00,1087.57,318093.23,Essential
535,11/02/2023,Beauty,true,4438796341506,120.44,0.00,317972.79,Non-important
536,11/02/2023,Music,true,4670491009961,2338.67,0.00,315634.12,Important
537,11/02/2023,Outdoors,true,4010780685103,2060.48,0.00,313573.64,Important
538,11/02/2023,Outdoors,true,4690951037540,789.35,0.00,312784.29,Non-Essential
539,11/02/2023,Movies,true,4024413810995,1204.06,0.00,311580.23,Essential
540,12/02/2023,Automotive,false,4977484502241,0.00,21.25,311601.48,Non-Essential
541,12/02/2023,Tools,false,4455329763292,0.00,829.44,312430.92,Non-Essential
542,12/02/2023,Games,true,4492021661385,1961.53,0.00,310469.39,Non-Essential
543,12/02/2023,Electronics,true,4519238927502,2792.92,0.00,307676.47,Important
544,12/02/2023,Health,true,4984465001849,2384.88,0.00,305291.59,Non-important
545,12/02/2023,Baby,false,4248002990633,0.00,981.13,306272.72,Important
546,12/02/2023,Outdoors,true,4558993490950,210.84,0.00,306061.88,Non-important
547,12/02/2023,Automotive,true,4095202742574,2064.55,0.00,303997.33,Non-important
548,12/02/2023,Beauty,false,4916766710863,0.00,1003.46,305000.79,Essential
549,12/02/2023,Games,true,4003398726969,2211.19,0.00,302789.60,Non-Essential
550,12/02/2023,Home,true,4977185461798,1068.63,0.00,301720.97,Non-Essential
551,12/02/2023,Beauty,true,4845659240236,65.36,0.00,301655.61,Important
552,12/02/2023,Electronics,false,4764771076539,0.00,1660.18,303315.79,Important
553,12/02/2023,Books,false,4949239878839,0.00,1342.56,304658.35,Essential
554,12/02/2023,Home,true,4365225012354,372.48,0.00,304285.87,Non-important
555,12/02/2023,Books,true,4042343345106,318.91,0.00,303966.96,Non-important
556,12/02/2023,Music,true,4663327781856,431.57,0.00,303535.39,Essential
557,12/02/2023,Games,true,4648516349311,1680.44,0.00,301854.95,Non-Essential
558,12/02/2023,Electronics,false,4215014736595,0.00,150.25,302005.20,Important
559,13/02/2023,Toys,false,4702871242140,0.00,2667.11,304672.31,Essential
560,13/02/2023,Sports,false,4340871433589,0.00,73.98,304746.29,Important
561,13/02/2023,Music,true,4878001919419,2277.08,0.00,302469.21,Important
562,13/02/2023,Jewelry,true,4609380805321,2195.94,0.00,300273.27,Essential
563,13/02/2023,Sports,false,4305209955740,0.00,663.26,300936.53,Non-Essential
564,13/02/2023,Grocery,true,4609788482863,2004.31,0.00,298932.22,Essential
565,13/02/2023,Grocery,true,4714446329261,2230.24,0.00,296701.98,Essential
566,13/02/2023,Movies,false,4496165673892,0.00,2230.40,298932.38,Non-Essential
567,13/02/2023,Tools,true,4334916168571,808.69,0.00,298123.69,Important
568,14/02/2023,Beauty,false,4436649559833,0.00,2884.09,301007.78,Non-important
569,14/02/2023,Tools,false,4300331756765,0.00,1464.76,302472.54,Non-Essential
570,14/02/2023,Beauty,false,4560330598230,0.00,2750.40,305222.94,Non-Essential
571,14/02/2023,Sports,false,4953634262272,0.00,2109.61,307332.55,Non-important
572,14/02/2023,Beauty,true,4912647617199,2084.20,0.00,305248.35,Non-Essential
573,14/02/2023,Industrial,true,4422543568925,2436.42,0.00,302811.93,Non-Essential
574,14/02/2023,Games,true,4638353686750,795.03,0.00,302016.90,Important
575,14/02/2023,Jewelry,false,4806067511348,0.00,1728.64,303745.54,Essential
576,14/02/2023,Clothing,false,4967926325961,0.00,1063.24,304808.78,Non-Essential
577,14/02/2023,Games,true,4680962097399,417.14,0.00,304391.64,Non-Essential
578,14/02/2023,Shoes,false,4722308962503,0.00,1887.87,306279.51,Important
579,14/02/2023,Shoes,true,4293819910236,1498.98,0.00,304780.53,Essential
580,14/02/2023,Sports,true,4728059765221,2878.19,0.00,301902.34,Important
581,14/02/2023,Music,true,4300163987304,235.85,0.00,301666.49,Non-important
582,14/02/2023,Computers,false,4668861247460,0.00,2466.74,304133.23,Important
583,14/02/2023,Music,false,4935054545367,0.00,389.40,304522.63,Important
584,14/02/2023,Industrial,true,4404133406906,2035.16,0.00,302487.47,Non-Essential
585,14/02/2023,Electronics,true,4242678455082,2002.19,0.00,300485.28,Important
586,14/02/2023,Jewelry,true,4453175795829,1548.86,0.00,298936.42,Essential
587,15/02/2023,Shoes,true,4613784277657,2743.67,0.00,296192.75,Essential
588,15/02/2023,Industrial,true,4779222109443,480.36,0.00,295712.39,Non-important
589,15/02/2023,Industrial,true,4821669357363,1118.05,0.00,294594.34,Non-Essential
590,15/02/2023,Garden,true,4887191998619,2262.02,0.00,292332.32,Non-important
591,15/02/2023,Computers,false,4781439418637,0.00,1156.70,293489.02,Essential
592,15/02/2023,Tools,true,4291455887959,2342.54,0.00,291146.48,Essential
593,15/02/2023,Outdoors,false,4176437796473,0.00,1266.87,292413.35,Important
594,15/02/2023,Electronics,false,4450234441621,0.00,139.49,292552.84,Non-important
595,15/02/2023,Toys,false,4494843308210,0.00,265.58,292818.42,Non-Essential
596,15/02/2023,Kids,true,4837233389652,1287.15,0.00,291531.27,Important
597,15/02/2023,Industrial,true,4866379201037,1436.54,0.00,290094.73,Important
598,15/02/2023,Kids,true,4719969685351,54.72,0.00,290040.01,Non-Essential
599,15/02/2023,Music,true,4322341979528,102.23,0.00,289937.78,Non-Essential
600,16/02/2023,Shoes,false,4788337860637,0.00,2732.67,292670.45,Non-Essential
601,16/02/2023,Movies,true,4421330117108,2773.90,0.00,289896.55,Non-Essential
602,16/02/2023,Kids,true,4091643498092,1265.38,0.00,288631.17,Non-important
603,16/02/2023,Shoes,false,4520704300534,0.00,2642.37,291273.54,Important
604,16/02/2023,Shoes,false,4597205807700,0.00,2787.10,294060.64,Essential
605,16/02/2023,Health,true,4818783193225,409.13,0.00,293651.51,Non-Essential
606,16/02/2023,Grocery,false,4250544846490,0.00,2474.99,296126.50,Essential
607,16/02/2023,Outdoors,false,4149904161419,0.00,1296.48,297422.98,Non-important
608,16/02/2023,Industrial,false,4473173249213,0.00,1690.84,299113.82,Essential
609,16/02/2023,Health,false,4812473824792,0.00,1327.91,300441.73,Essential
610,17/02/2023,Automotive,false,4833786629639,0.00,2240.62,302682.35,Important
611,17/02/2023,Jewelry,false,4641409527743,0.00,1412.90,304095.25,Important
612,17/02/2023,Music,false,4355289208487,0.00,1582.40,305677.65,Non-Essential
613,17/02/2023,Grocery,true,4839403491345,2297.34,0.00,303380.31,Essential
614,17/02/2023,Shoes,true,4519503076429,2102.66,0.00,301277.65,Essential
615,17/02/2023,Outdoors,false,4293381796967,0.00,2246.60,303524.25,Non-important
616,17/02/2023,Electronics,false,4908688825705,0.00,1808.81,305333.06,Essential
617,17/02/2023,Music,false,4918544455694,0.00,1292.04,306625.10,Important
618,17/02/2023,Garden,true,4143831748816,2003.48,0.00,304621.62,Non-Essential
619,17/02/2023,Garden,true,4249243333261,1833.58,0.00,302788.04,Non-important
620,17/02/2023,Electronics,false,4549823178924,0.00,2212.58,305000.62,Important
621,17/02/2023,Games,true,4233792525583,1141.18,0.00,303859.44,Essential
622,17/02/2023,Music,true,4168229613071,2938.02,0.00,300921.42,Non-Essential
623,17/02/2023,Kids,true,4334636859166,2065.11,0.00,298856.31,Non-Essential
624,18/02/2023,Industrial,false,4076279344277,0.00,1689.02,300545.33,Important
625,18/02/2023,Outdoors,true,4512148266773,1236.12,0.00,299309.21,Important
626,18/02/2023,Clothing,false,4119169526900,0.00,340.20,299649.41,Non-important
627,18/02/2023,Electronics,false,4614069430428,0.00,199.11,299848.52,Essential
628,18/02/2023,Jewelry,true,4889494262745,47.18,0.00,299801.34,Non-important
629,18/02/2023,Health,false,4182170326952,0.00,1615.09,301416.43,Non-Essential
630,18/02/2023,Music,false,4456923120766,0.00,1736.55,303152.98,Non-Essential
631,18/02/2023,Games,false,4786386841224,0.00,1905.54,305058.52,Non-important
632,18/02/2023,Clothing,true,4551522350652,2422.54,0.00,302635.98,Important
633,18/02/2023,Grocery,true,4297541226739,264.96,0.00,302371.02,Non-Essential
634,19/02/2023,Beauty,false,4702961043838,0.00,1189.71,303560.73,Essential
635,19/02/2023,Jewelry,false,4586020093849,0.00,557.77,304118.50,Non-important
636,19/02/2023,Computers,false,4216262253129,0.00,2398.02,306516.52,Essential
637,19/02/2023,Books,false,4363688807989,0.00,531.37,307047.89,Important
638,19/02/2023,Industrial,true,4489165854084,912.64,0.00,306135.25,Non-important
639,19/02/2023,Automotive,false,4812011434163,0.00,2921.84,309057.09,Non-important
640,19/02/2023,Grocery,true,4092180226895,2514.81,0.00,306542.28,Non-Essential
641,19/02/2023,Jewelry,true,4488894327331,2646.37,0.00,303895.91,Essential
642,19/02/2023,Music,true,4057262860437,2907.83,0.00,300988.08,Non-important
643,20/02/2023,Industrial,false,4283506350727,0.00,2368.72,303356.80,Important
644,20/02/2023,Outdoors,false,4559633125307,0.00,1326.16,304682.96,Non-important
645,20/02/2023,Jewelry,true,4840753118907,1894.98,0.00,302787.98,Essential
646,20/02/2023,Health,false,4937345911286,0.00,2313.68,305101.66,Non-important
647,20/02/2023,Outdoors,true,4387328171953,1786.27,0.00,303315.39,Important
648,20/02/2023,Music,false,4802433386363,0.00,2941.15,306256.54,Essential
649,20/02/2023,Toys,true,4843936492621,1249.19,0.00,305007.35,Essential
650,20/02/2023,Computers,true,4571832988498,1594.72,0.00,303412.63,Important
651,20/02/2023,Health,false,4575137119402,0.00,919.35,304331.98,Non-Essential
652,20/02/2023,Kids,false,4128215762994,0.00,894.56,305226.54,Essential
653,20/02/2023,Sports,false,4651003805855,0.00,2273.39,307499.93,Important
654,20/02/2023,Shoes,false,4040063277935,0.00,2624.52,310124.45,Non-Essential
655,20/02/2023,Home,false,4715791268812,0.00,1052.02,311176.47,Non-important
656,20/02/2023,Clothing,false,4312854988249,0.00,1180.91,312357.38,Essential
657,20/02/2023,Outdoors,false,4450226516233,0.00,880.21,313237.59,Essential
658,20/02/2023,Home,true,4419252438010,2769.19,0.00,310468.40,Non-Essential
659,20/02/2023,Baby,true,4785862462519,624.90,0.00,309843.50,Important
660,20/02/2023,Jewelry,true,4821474546389,1828.98,0.00,308014.52,Non-important
661,20/02/2023,Beauty,true,4906025966440,1727.87,0.00,306286.65,Non-Essential
662,20/02/2023,Computers,true,4937437914111,183.41,0.00,306103.24,Important
663,20/02/2023,Shoes,false,4666275090343,0.00,2273.06,308376.30,Essential
664,21/02/2023,Automotive,false,4150759950087,0.00,2618.63,310994.93,Non-important
665,21/02/2023,Sports,true,4807620325544,1793.06,0.00,309201.87,Essential
666,21/02/2023,Computers,true,4698428367822,1969.59,0.00,307232.28,Essential
667,21/02/2023,Tools,true,4210041880093,2749.95,0.00,304482.33,Important
668,21/02/2023,Jewelry,false,4407078006335,0.00,1437.18,305919.51,Non-Essential
669,21/02/2023,Kids,false,4260252471949,0.00,1034.80,306954.31,Non-Essential
670,21/02/2023,Grocery,true,4322255111336,319.19,0.00,306635.12,Essential
671,21/02/2023,Music,true,4252277137081,647.05,0.00,305988.07,Non-Essential
672,21/02/2023,Home,false,4209004571358,0.00,2959.93,308948.00,Essential
673,21/02/2023,Home,true,4971596310099,2750.72,0.00,306197.28,Non-Essential
674,21/02/2023,Computers,false,4735818851135,0.00,2083.27,308280.55,Non-important
675,21/02/2023,Movies,false,4158121910853,0.00,1630.23,309910.78,Non-important
676,21/02/2023,Garden,true,4264659834484,529.63,0.00,309381.15,Non-important
677,21/02/2023,Home,false,4991366781297,0.00,2256.47,311637.62,Non-important
678,21/02/2023,Shoes,true,4774102462068,2238.90,0.00,309398.72,Non-Essential
679,21/02/2023,Kids,true,4389030379030,426.75,0.00,308971.97,Non-Essential
680,22/02/2023,Games,true,4979935969084,589.92,0.00,308382.05,Essential
681,22/02/2023,Industrial,true,4898303270643,2732.99,0.00,305649.06,Essential
682,22/02/2023,Baby,true,4731501862887,2544.28,0.00,303104.78,Non-important
683,22/02/2023,Garden,false,4090263795236,0.00,2981.54,306086.32,Essential
684,22/02/2023,Beauty,true,4735848172557,2246.36,0.00,303839.96,Non-important
685,22/02/2023,Shoes,false,4271955581095,0.00,802.18,304642.14,Essential
686,22/02/2023,Movies,true,4249647719839,268.04,0.00,304374.10,Important
687,22/02/2023,Shoes,false,4414763386874,0.00,92.35,304466.45,Non-important
688,22/02/2023,Tools,true,4386926846340,420.90,0.00,304045.55,Essential
689,22/02/2023,Shoes,true,4096885015126,574.03,0.00,303471.52,Essential
690,22/02/2023,Home,true,4640802345297,1197.09,0.00,302274.43,Essential
691,22/02/2023,Garden,true,4838206208212,2484.55,0.00,299789.88,Non-important
692,22/02/2023,Shoes,true,4755321447853,2520.82,0.00,297269.06,Non-important
693,22/02/2023,Electronics,false,4852112599705,0.00,805.99,298075.05,Non-Essential
694,22/02/2023,Industrial,true,4320350348544,569.73,0.00,297505.32,Essential
695,22/02/2023,Books,true,4897943409590,2245.14,0.00,295260.18,Essential
696,23/02/2023,Toys,true,4361641512072,1823.36,0.00,293436.82,Non-Essential
697,23/02/2023,Garden,false,4248165803654,0.00,2161.47,295598.29,Non-important
698,23/02/2023,Beauty,false,4410634790508,0.00,1769.44,297367.73,Essential
699,23/02/2023,Music,true,4760405626690,321.01,0.00,297046.72,Non-Essential
700,23/02/2023,Kids,true,4206032498868,912.00,0.00,296134.72,Non-Essential
701,23/02/2023,Jewelry,true,4562458637894,1593.10,0.00,294541.62,Non-Essential
702,23/02/2023,Tools,false,4132198783448,0.00,490.27,295031.89,Non-important
703,23/02/2023,Home,true,4907803655017,1370.87,0.00,293661.02,Essential
704,23/02/2023,Kids,true,4576305221546,2769.24,0.00,290891.78,Essential
705,23/02/2023,Books,false,4448864863828,0.00,995.62,291887.40,Non-Essential
706,23/02/2023,Automotive,false,4901223672176,0.00,2169.84,294057.24,Non-important
707,23/02/2023,Games,true,4074743605411,2896.85,0.00,291160.39,Important
708,23/02/2023,Outdoors,true,4534865024842,2932.25,0.00,288228.14,Important
709,24/02/2023,Health,true,4114488456410,1588.13,0.00,286640.01,Essential
710,24/02/2023,Kids,true,4848877670454,2014.86,0.00,284625.15,Non-Essential
711,24/02/2023,Tools,true,4740903529872,2647.09,0.00,281978.06,Non-important
712,24/02/2023,Garden,true,4413779836555,2397.59,0.00,279580.47,Non-important
713,24/02/2023,Baby,true,4155418065781,2336.83,0.00,277243.64,Important
714,24/02/2023,Grocery,true,4108032500024,2502.41,0.00,274741.23,Non-Essential
715,24/02/2023,Automotive,true,4980639105450,668.31,0.00,274072.92,Important
716,24/02/2023,Movies,true,4526454379263,2564.64,0.00,271508.28,Non-Essential
717,24/02/2023,Baby,true,4679260324324,1993.36,0.00,269514.92,Non-important
718,24/02/2023,Kids,true,4398399815101,2812.98,0.00,266701.94,Important
719,24/02/2023,Outdoors,true,4445093168216,2633.14,0.00,264068.80,Non-Essential
720,25/02/2023,Sports,true,4651176210539,1289.43,0.00,262779.37,Important
721,25/02/2023,Jewelry,false,4252584311927,0.00,336.31,263115.68,Important
722,25/02/2023,Beauty,false,4705118952437,0.00,210.48,263326.16,Essential
723,25/02/2023,Kids,false,4363241215841,0.00,871.15,264197.31,Essential
724,26/02/2023,Baby,false,4686654617120,0.00,2395.15,266592.46,Essential
725,26/02/2023,Clothing,true,4526328872879,678.73,0.00,265913.73,Essential
726,26/02/2023,Movies,false,4586027438072,0.00,2737.41,268651.14,Important
727,26/02/2023,Home,true,4929605412236,580.55,0.00,268070.59,Non-important
728,26/02/2023,Movies,true,4625830571747,2291.06,0.00,265779.53,Important
729,26/02/2023,Kids,true,4907981654095,2785.42,0.00,262994.11,Essential
730,26/02/2023,Clothing,true,4153226633230,2358.69,0.00,260635.42,Non-Essential
731,26/02/2023,Beauty,false,4483490597425,0.00,918.51,261553.93,Important
732,26/02/2023,Kids,false,4029937961859,0.00,2227.32,263781.25,Non-important
733,26/02/2023,Baby,true,4551024169561,2940.76,0.00,260840.49,Non-Essential
734,26/02/2023,Computers,false,4956781369235,0.00,168.35,261008.84,Non-important
735,26/02/2023,Toys,false,4781716663650,0.00,2193.77,263202.61,Non-important
736,27/02/2023,Beauty,false,4968582550074,0.00,950.23,264152.84,Non-Essential
737,27/02/2023,Clothing,false,4098122349679,0.00,1118.71,265271.55,Essential
738,27/02/2023,Electronics,true,4548527520384,2667.15,0.00,262604.40,Essential
739,27/02/2023,Kids,true,4185453074630,256.65,0.00,262347.75,Non-important
740,27/02/2023,Electronics,false,4106218410056,0.00,1193.16,263540.91,Important
741,27/02/2023,Books,false,4663040796936,0.00,1617.14,265158.05,Important
742,28/02/2023,Beauty,false,4253836500164,0.00,1435.43,266593.48,Non-Essential
743,28/02/2023,Clothing,false,4215863882324,0.00,1075.27,267668.75,Important
744,28/02/2023,Kids,false,4212492997760,0.00,1798.25,269467.00,Essential
745,28/02/2023,Beauty,false,4197992178662,0.00,1988.19,271455.19,Non-important
746,28/02/2023,Garden,true,4160777965598,1907.50,0.00,269547.69,Essential
747,28/02/2023,Grocery,true,4946743636001,989.27,0.00,268558.42,Essential
748,28/02/2023,Tools,true,4713625894144,1656.07,0.00,266902.35,Non-Essential
749,28/02/2023,Music,true,4870551508268,26.25,0.00,266876.10,Non-important
750,28/02/2023,Kids,true,4679526827233,2484.39,0.00,264391.71,Essential
751,28/02/2023,Industrial,false,4728329538988,0.00,2220.05,266611.76,Non-Essential
752,28/02/2023,Baby,true,4524094377769,1176.70,0.00,265435.06,Non-Essential
753,28/02/2023,Beauty,false,4964829141574,0.00,1709.16,267144.22,Essential
754,28/02/2023,Electronics,false,4502350568380,0.00,863.16,268007.38,Essential
755,28/02/2023,Jewelry,false,4851222409735,0.00,2095.05,270102.43,Non-Essential
756,01/03/2023,Baby,true,4849726573098,993.98,0.00,269108.45,Non-important
757,01/03/2023,Kids,true,4639587411000,1778.49,0.00,267329.96,Essential
758,01/03/2023,Baby,true,4999504618308,2061.62,0.00,265268.34,Non-important
759,01/03/2023,Clothing,false,4833535417412,0.00,1949.63,267217.97,Essential
760,01/03/2023,Outdoors,false,4169931479323,0.00,248.66,267466.63,Non-important
761,01/03/2023,Automotive,true,4097742332286,562.48,0.00,266904.15,Important
762,01/03/2023,Games,true,4040304849962,1933.77,0.00,264970.38,Non-important
763,01/03/2023,Games,false,4914763893603,0.00,1841.44,266811.82,Non-Essential
764,01/03/2023,Health,false,4427058389438,0.00,2628.28,269440.10,Non-important
765,01/03/2023,Tools,true,4066819436430,2300.71,0.00,267139.39,Non-Essential
766,01/03/2023,Shoes,false,4723059634902,0.00,838.07,267977.46,Non-Essential
767,01/03/2023,Sports,true,4241762055561,864.37,0.00,267113.09,Important
768,02/03/2023,Games,true,4644166821826,1196.35,0.00,265916.74,Important
769,02/03/2023,Health,false,4103815828072,0.00,2455.05,268371.79,Non-Essential
770,02/03/2023,Computers,false,4458530100268,0.00,1278.18,269649.97,Non-important
771,02/03/2023,Health,false,4678087954191,0.00,2440.74,272090.71,Essential
772,02/03/2023,Grocery,true,4550652103935,287.92,0.00,271802.79,Non-important
773,02/03/2023,Tools,false,4903715156421,0.00,2979.81,274782.60,Non-Essential
774,02/03/2023,Computers,true,4696785570272,2347.43,0.00,272435.17,Important
775,02/03/2023,Industrial,false,4968113955032,0.00,1544.18,273979.35,Essential
776,02/03/2023,Health,true,4865946009118,745.30,0.00,273234.05,Non-Essential
777,02/03/2023,Clothing,true,4708587510373,1733.46,0.00,271500.59,Non-Essential
778,02/03/2023,Garden,false,4579471504235,0.00,547.54,272048.13,Essential
779,02/03/2023,Books,false,4613173021932,0.00,2674.71,274722.84,Non-Essential
780,02/03/2023,Automotive,false,4103142820106,0.00,1760.29,276483.13,Non-important
781,02/03/2023,Kids,false,4375672309382,0.00,1797.12,278280.25,Essential
782,02/03/2023,Garden,true,4323503064739,758.84,0.00,277521.41,Essential
783,03/03/2023,Clothing,false,4263047281085,0.00,565.92,278087.33,Non-Essential
784,03/03/2023,Tools,false,4002763786411,0.00,1560.43,279647.76,Important
785,03/03/2023,Movies,false,4178274123649,0.00,2103.60,281751.36,Non-Essential
786,03/03/2023,Beauty,true,4409980775539,475.24,0.00,281276.12,Important
787,03/03/2023,Home,true,4154616392139,2404.88,0.00,278871.24,Non-Essential
788,03/03/2023,Games,false,4553305490366,0.00,520.61,279391.85,Essential
789,03/03/2023,Automotive,true,4295352890161,436.12,0.00,278955.73,Non-Essential
790,03/03/2023,Tools,true,4031631860394,2183.07,0.00,276772.66,Non-important
791,03/03/2023,Beauty,false,4616725428842,0.00,2258.46,279031.12,Non-Essential
792,04/03/2023,Outdoors,false,4875106497130,0.00,860.20,279891.32,Essential
793,04/03/2023,Computers,false,4024102643560,0.00,1163.77,281055.09,Non-Essential
794,04/03/2023,Music,false,4489921308850,0.00,456.87,281511.96,Non-Essential
795,04/03/2023,Electronics,true,4052717660572,1308.79,0.00,280203.17,Important
796,04/03/2023,Games,true,4334964425214,1286.47,0.00,278916.70,Non-important
797,04/03/2023,Jewelry,true,4979209236315,1888.37,0.00,277028.33,Non-Essential
798,04/03/2023,Movies,true,4751996734534,253.71,0.00,276774.62,Non-Essential
799,05/03/2023,Home,true,4966856316701,1647.22,0.00,275127.40,Non-Essential
800,05/03/2023,Books,false,4047974875375,0.00,1256.78,276384.18,Non-important
801,05/03/2023,Music,true,4553134712951,2092.39,0.00,274291.79,Important
802,05/03/2023,Kids,true,4755905241227,488.45,0.00,273803.34,Non-important
803,05/03/2023,Grocery,false,4376293093382,0.00,2837.88,276641.22,Essential
804,05/03/2023,Outdoors,true,4710766041419,221.22,0.00,276420.00,Essential
805,05/03/2023,Clothing,false,4800100591647,0.00,2271.18,278691.18,Non-important
806,05/03/2023,Outdoors,true,4203822848554,2135.01,0.00,276556.17,Important
807,05/03/2023,Clothing,false,4007997356091,0.00,539.49,277095.66,Essential
808,05/03/2023,Electronics,false,4085307022802,0.00,2149.71,279245.37,Non-important
809,05/03/2023,Jewelry,false,4405952393393,0.00,2414.19,281659.56,Important
810,05/03/2023,Home,false,4330525729914,0.00,1626.47,283286.03,Non-important
811,06/03/2023,Garden,false,4307233758638,0.00,2191.15,285477.18,Non-important
812,06/03/2023,Shoes,false,4881124581509,0.00,1349.87,286827.05,Essential
813,06/03/2023,Garden,true,4542973881139,2671.72,0.00,284155.33,Essential
814,06/03/2023,Electronics,true,4456659683669,970.92,0.00,283184.41,Essential
815,06/03/2023,Clothing,false,4015310809219,0.00,202.90,283387.31,Essential
816,06/03/2023,Garden,true,4995563471241,388.99,0.00,282998.32,Essential
817,06/03/2023,Industrial,false,4758278329057,0.00,1078.78,284077.10,Important
818,06/03/2023,Computers,false,4258985805019,0.00,2662.99,286740.09,Important
819,06/03/2023,Industrial,false,4548694289872,0.00,1287.56,288027.65,Non-Essential
820,06/03/2023,Tools,true,4316802268021,143.89,0.00,287883.76,Essential
821,06/03/2023,Home,false,4000414241304,0.00,2492.17,290375.93,Important
822,06/03/2023,Home,true,4723438357822,1057.26,0.00,289318.67,Essential
823,06/03/2023,Jewelry,false,4646173771194,0.00,1360.63,290679.30,Non-important
824,07/03/2023,Kids,false,4796290525470,0.00,819.32,291498.62,Non-Essential
825,07/03/2023,Music,false,4206329245281,0.00,468.59,291967.21,Non-Essential
826,07/03/2023,Home,false,4837810255784,0.00,232.74,292199.95,Non-important
827,07/03/2023,Baby,true,4437208295701,209.28,0.00,291990.67,Important
828,07/03/2023,Books,false,4768473769363,0.00,2985.05,294975.72,Essential
829,07/03/2023,Kids,false,4766700440055,0.00,1133.32,296109.04,Essential
830,07/03/2023,Computers,false,4589783984646,0.00,2441.38,298550.42,Important
831,07/03/2023,Games,true,4151970447421,739.40,0.00,297811.02,Essential
832,07/03/2023,Games,false,4668137523845,0.00,2005.43,299816.45,Non-important
833,08/03/2023,Computers,false,4610113676969,0.00,1999.98,301816.43,Essential
834,08/03/2023,Games,false,4151868422372,0.00,1436.92,303253.35,Essential
835,08/03/2023,Home,false,4272144549874,0.00,875.03,304128.38,Important
836,08/03/2023,Movies,true,4910795290098,2031.20,0.00,302097.18,Non-important
837,08/03/2023,Tools,false,4091465228317,0.00,434.58,302531.76,Important
838,08/03/2023,Baby,false,4414812680433,0.00,1566.45,304098.21,Non-Essential
839,08/03/2023,Music,true,4491667393022,969.97,0.00,303128.24,Important
840,08/03/2023,Garden,false,4205299758431,0.00,2839.58,305967.82,Non-Essential
841,08/03/2023,Books,false,4389582706281,0.00,1433.59,307401.41,Essential
842,08/03/2023,Electronics,true,4962039661846,2711.93,0.00,304689.48,Non-Essential
843,08/03/2023,Industrial,true,4426971267051,1968.18,0.00,302721.30,Non-Essential
844,09/03/2023,Outdoors,false,4013707925068,0.00,2446.15,305167.45,Non-Essential
845,09/03/2023,Tools,true,4619517302194,182.45,0.00,304985.00,Non-important
846,09/03/2023,Health,false,4695909242608,0.00,2505.84,307490.84,Non-important
847,09/03/2023,Movies,false,4658516818559,0.00,2055.16,309546.00,Essential
848,09/03/2023,Garden,false,4152674928187,0.00,916.28,310462.28,Important
849,09/03/2023,Shoes,false,4647116612909,0.00,1683.70,312145.98,Non-important
850,09/03/2023,Books,false,4960045433742,0.00,8.13,312154.11,Important
851,09/03/2023,Electronics,false,4166184375351,0.00,962.61,313116.72,Non-Essential
852,09/03/2023,Tools,true,4914331573111,1073.21,0.00,312043.51,Non-Essential
853,09/03/2023,Beauty,false,4574399494772,0.00,587.31,312630.82,Non-important
854,09/03/2023,Outdoors,true,4658151911840,1376.88,0.00,311253.94,Non-important
855,10/03/2023,Movies,false,4754211231712,0.00,1363.17,312617.11,Important
856,10/03/2023,Games,false,4738752068469,0.00,1109.56,313726.67,Essential
857,10/03/2023,Music,false,4687769263287,0.00,2935.16,316661.83,Important
858,10/03/2023,Books,true,4412646842745,2701.35,0.00,313960.48,Non-Essential
859,10/03/2023,Clothing,true,4292690001995,2773.03,0.00,311187.45,Essential
860,10/03/2023,Grocery,false,4279229574280,0.00,1458.37,312645.82,Non-Essential
861,10/03/2023,Garden,true,4939987508810,1587.41,0.00,311058.41,Important
862,10/03/2023,Computers,true,4220346659705,762.02,0.00,310296.39,Important
863,11/03/2023,Industrial,true,4254778898201,1460.38,0.00,308836.01,Non-Essential
864,11/03/2023,Sports,true,4908124924949,1478.50,0.00,307357.51,Non-important
865,11/03/2023,Computers,true,4725891299050,57.65,0.00,307299.86,Important
866,11/03/2023,Kids,false,4069378996003,0.00,878.45,308178.31,Important
867,11/03/2023,Books,false,4201276526234,0.00,1763.60,309941.91,Essential
868,11/03/2023,Books,false,4352524178068,0.00,1576.27,311518.18,Non-important
869,11/03/2023,Toys,true,4343932170205,1380.43,0.00,310137.75,Non-Essential
870,11/03/2023,Automotive,true,4825871524055,2860.95,0.00,307276.80,Important
871,11/03/2023,Movies,false,4840291439714,0.00,2974.37,310251.17,Essential
872,11/03/2023,Outdoors,true,4896904676588,1419.51,0.00,308831.66,Essential
873,12/03/2023,Outdoors,true,4300564612897,535.45,0.00,308296.21,Non-important
874,12/03/2023,Home,true,4733336448366,2161.92,0.00,306134.29,Essential
875,12/03/2023,Outdoors,false,4119610659257,0.00,522.13,306656.42,Essential
876,12/03/2023,Jewelry,false,4377640677516,0.00,509.29,307165.71,Essential
877,12/03/2023,Automotive,false,4837191322796,0.00,2344.13,309509.84,Non-Essential
878,12/03/2023,Garden,true,4618154450810,1956.63,0.00,307553.21,Non-important
879,12/03/2023,Garden,false,4664313204636,0.00,975.50,308528.71,Essential
880,12/03/2023,Movies,true,4745484705936,2177.11,0.00,306351.60,Important
881,12/03/2023,Toys,false,4699528597187,0.00,2527.44,308879.04,Essential
882,12/03/2023,Movies,false,4837502055448,0.00,1484.96,310364.00,Non-important
883,12/03/2023,Clothing,false,4831667456963,0.00,1262.26,311626.26,Non-Essential
884,12/03/2023,Kids,false,4517787281732,0.00,920.68,312546.94,Non-Essential
885,13/03/2023,Baby,true,4892013030286,2068.17,0.00,310478.77,Important
886,13/03/2023,Garden,false,4975682977001,0.00,1668.65,312147.42,Essential
887,13/03/2023,Beauty,true,4024394189540,2011.40,0.00,310136.02,Essential
888,13/03/2023,Books,false,4240380498144,0.00,2520.49,312656.51,Non-Essential
889,13/03/2023,Clothing,true,4231217395492,1433.96,0.00,311222.55,Non-important
890,13/03/2023,Outdoors,true,4252337821844,1386.11,0.00,309836.44,Important
891,13/03/2023,Automotive,false,4801777723968,0.00,1812.53,311648.97,Non-important
892,13/03/2023,Games,true,4816832177342,1309.12,0.00,310339.85,Essential
893,13/03/2023,Toys,true,4989640966491,2647.53,0.00,307692.32,Important
894,13/03/2023,Kids,true,4732736859057,162.16,0.00,307530.16,Essential
895,13/03/2023,Tools,false,4217559564577,0.00,2259.06,309789.22,Essential
896,13/03/2023,Sports,true,4064641000239,96.35,0.00,309692.87,Essential
897,14/03/2023,Books,false,4515469299458,0.00,1623.33,311316.20,Non-Essential
898,14/03/2023,Home,false,4435489568407,0.00,2863.60,314179.80,Non-important
899,14/03/2023,Automotive,false,4076579708833,0.00,32.13,314211.93,Essential
900,14/03/2023,Shoes,false,4030669647759,0.00,1526.23,315738.16,Non-Essential
901,14/03/2023,Sports,false,4586741219992,0.00,1096.69,316834.85,Essential
902,14/03/2023,Computers,true,4197080235798,22.07,0.00,316812.78,Non-important
903,15/03/2023,Outdoors,false,4365501807377,0.00,2451.08,319263.86,Important
904,15/03/2023,Clothing,true,4489387918265,1290.08,0.00,317973.78,Non-important
905,15/03/2023,Industrial,false,4998238375277,0.00,1864.10,319837.88,Non-important
906,15/03/2023,Books,false,4795023919326,0.00,2469.55,322307.43,Non-Essential
907,15/03/2023,Garden,false,4844451002109,0.00,101.06,322408.49,Non-important
908,15/03/2023,Industrial,false,4076152576593,0.00,1051.89,323460.38,Non-important
909,15/03/2023,Grocery,true,4585465042434,2808.78,0.00,320651.60,Non-Essential
910,15/03/2023,Health,false,4761217314110,0.00,2658.95,323310.55,Important
911,15/03/2023,Kids,false,4853566667664,0.00,368.69,323679.24,Non-Essential
912,16/03/2023,Industrial,false,4458896579236,0.00,2418.81,326098.05,Non-Essential
913,16/03/2023,Movies,false,4756373432943,0.00,2038.01,328136.06,Non-important
914,16/03/2023,Sports,false,4972644301407,0.00,2027.95,330164.01,Essential
915,16/03/2023,Books,true,4908712268041,2667.83,0.00,327496.18,Essential
916,16/03/2023,Grocery,true,4811607122481,66.18,0.00,327430.00,Important
917,16/03/2023,Kids,true,4968030892615,906.92,0.00,326523.08,Essential
918,16/03/2023,Grocery,false,4726626339746,0.00,130.40,326653.48,Non-Essential
919,16/03/2023,Books,false,4764001600531,0.00,2103.86,328757.34,Important
920,16/03/2023,Clothing,false,4169317783547,0.00,2409.80,331167.14,Essential
921,16/03/2023,Kids,false,4045930845557,0.00,564.26,331731.40,Non-Essential
922,16/03/2023,Music,false,4438373520223,0.00,2239.50,333970.90,Non-Essential
923,16/03/2023,Baby,true,4763165613006,1214.47,0.00,332756.43,Non-important
924,17/03/2023,Jewelry,false,4177034651769,0.00,2494.35,335250.78,Essential
925,17/03/2023,Shoes,false,4622239095241,0.00,1817.14,337067.92,Non-important
926,17/03/2023,Games,false,4258686634629,0.00,952.10,338020.02,Non-Essential
927,17/03/2023,Baby,true,4704532332275,1078.93,0.00,336941.09,Essential
928,17/03/2023,Clothing,false,4360115754149,0.00,981.60,337922.69,Important
929,17/03/2023,Computers,false,4305874865266,0.00,2653.72,340576.41,Non-Essential
930,17/03/2023,Jewelry,false,4490180961473,0.00,1471.88,342048.29,Essential
931,17/03/2023,Automotive,true,4979775793976,665.80,0.00,341382.49,Important
932,18/03/2023,Industrial,false,4388022741128,0.00,1248.59,342631.08,Essential
933,18/03/2023,Sports,false,4696749143123,0.00,2599.78,345230.86,Non-important
934,18/03/2023,Music,false,4810047405405,0.00,1581.23,346812.09,Important
935,18/03/2023,Jewelry,false,4846648849637,0.00,1922.45,348734.54,Essential
936,18/03/2023,Tools,true,4650638624110,541.11,0.00,348193.43,Important
937,18/03/2023,Sports,false,4220115911486,0.00,1697.85,349891.28,Non-Essential
938,19/03/2023,Kids,true,4314195882081,653.52,0.00,349237.76,Essential
939,19/03/2023,Tools,true,4052984642842,48.43,0.00,349189.33,Non-important
940,19/03/2023,Home,false,4003960470455,0.00,1466.67,350656.00,Non-Essential
941,19/03/2023,Clothing,false,4540927950841,0.00,616.55,351272.55,Non-Essential
942,19/03/2023,Automotive,true,4416052827049,2931.44,0.00,348341.11,Essential
943,19/03/2023,Outdoors,true,4889566518679,297.56,0.00,348043.55,Important
944,19/03/2023,Beauty,true,4475352172843,2780.95,0.00,345262.60,Non-important
945,19/03/2023,Clothing,false,4598848056070,0.00,2203.65,347466.25,Important
946,19/03/2023,Jewelry,false,4481929368644,0.00,1666.38,349132.63,Non-important
947,19/03/2023,Tools,false,4152061455172,0.00,2904.43,352037.06,Important
948,19/03/2023,Movies,false,4770617829118,0.00,2114.20,354151.26,Important
949,19/03/2023,Toys,true,4210179454037,1181.10,0.00,352970.16,Essential
950,19/03/2023,Toys,true,4873219662036,1155.12,0.00,351815.04,Important
951,20/03/2023,Movies,true,4142120849399,2872.85,0.00,348942.19,Essential
952,20/03/2023,Books,true,4950951091606,2342.06,0.00,346600.13,Non-Essential
953,20/03/2023,Garden,false,4320760952814,0.00,102.86,346702.99,Non-important
954,20/03/2023,Tools,true,4386886423511,725.00,0.00,345977.99,Non-Essential
955,20/03/2023,Grocery,false,4067267466013,0.00,2854.17,348832.16,Non-important
956,20/03/2023,Music,false,4047595803319,0.00,2451.52,351283.68,Non-Essential
957,20/03/2023,Garden,false,4356496567070,0.00,1724.54,353008.22,Important
958,20/03/2023,Home,true,4143682366835,2763.49,0.00,350244.73,Important
959,20/03/2023,Baby,false,4085527288743,0.00,874.09,351118.82,Non-important
960,20/03/2023,Industrial,true,4674447204302,1701.52,0.00,349417.30,Non-important
961,20/03/2023,Electronics,true,4264990378932,1844.87,0.00,347572.43,Non-Essential
962,20/03/2023,Games,true,4533131596380,154.85,0.00,347417.58,Essential
963,20/03/2023,Beauty,true,4390857678774,2751.35,0.00,344666.23,Essential
964,20/03/2023,Books,false,4775590736701,0.00,48.49,344714.72,Non-Essential
965,20/03/2023,Games,true,4949789563862,2204.06,0.00,342510.66,Non-important
966,20/03/2023,Books,true,4203840154668,1696.59,0.00,340814.07,Important
967,21/03/2023,Music,true,4855945176899,2281.52,0.00,338532.55,Non-important
968,21/03/2023,Beauty,true,4740517783545,1069.99,0.00,337462.56,Non-important
969,21/03/2023,Movies,true,4208465381574,1431.41,0.00,336031.15,Non-Essential
970,21/03/2023,Clothing,true,4032197809033,628.51,0.00,335402.64,Non-important
971,21/03/2023,Baby,false,4184067417720,0.00,1649.34,337051.98,Essential
972,21/03/2023,Tools,false,4779281896376,0.00,2104.19,339156.17,Essential
973,21/03/2023,Books,true,4295719081951,856.16,0.00,338300.01,Non-important
974,21/03/2023,Toys,false,4582756417657,0.00,1651.28,339951.29,Important
975,21/03/2023,Automotive,false,4341550152864,0.00,363.48,340314.77,Non-important
976,21/03/2023,Tools,true,4905555023706,1755.08,0.00,338559.69,Important
977,21/03/2023,Games,true,4993489153732,2874.79,0.00,335684.90,Non-important
978,21/03/2023,Baby,true,4141574715016,1544.50,0.00,334140.40,Non-important
979,21/03/2023,Music,false,4066760069231,0.00,506.14,334646.54,Non-Essential
980,21/03/2023,Shoes,false,4952485744690,0.00,1477.74,336124.28,Important
981,21/03/2023,Electronics,true,4273870467297,2246.04,0.00,333878.24,Non-important
982,21/03/2023,Books,true,4152897471315,1929.99,0.00,331948.25,Important
983,21/03/2023,Industrial,true,4376141224609,295.11,0.00,331653.14,Non-important
984,22/03/2023,Outdoors,false,4530307844015,0.00,2661.33,334314.47,Important
985,22/03/2023,Clothing,true,4559168351186,374.30,0.00,333940.17,Important
986,22/03/2023,Music,true,4311350964768,2104.57,0.00,331835.60,Non-important
987,22/03/2023,Grocery,false,4131380230655,0.00,2253.68,334089.28,Non-important
988,22/03/2023,Garden,false,4457683326452,0.00,1890.01,335979.29,Essential
989,22/03/2023,Industrial,true,4334730268685,599.03,0.00,335380.26,Non-Essential
990,22/03/2023,Books,true,4509212638116,2863.82,0.00,332516.44,Non-important
991,22/03/2023,Home,false,4933619184304,0.00,1346.63,333863.07,Non-important
992,22/03/2023,Industrial,false,4427763840044,0.00,1581.32,335444.39,Important
993,22/03/2023,Baby,true,4327358653511,2130.16,0.00,333314.23,Non-important
994,22/03/2023,Outdoors,false,4123239610388,0.00,463.53,333777.76,Important
995,22/03/2023,Toys,false,4662849075073,0.00,47.21,333824.97,Essential
996,22/03/2023,Shoes,true,4789406911909,118.54,0.00,333706.43,Essential
997,22/03/2023,Clothing,false,4646742365551,0.00,1218.19,334924.62,Important
998,22/03/2023,Sports,true,4946106907103,1158.89,0.00,333765.73,Essential
999,22/03/2023,Kids,false,4793107559986,0.00,1.26,333766.99,Essential
1000,22/03/2023,Outdoors,true,4245756153840,355.25,0.00,333411.74,Non-important
