row,Txn Date,Description,Transfer To/From,Ref No./Cheque No.,Debit,Credit,Balance,Class
1,23/12/2022,Toys,false,2235056301457,0.00,1453.89,540283.71,Important
2,23/12/2022,Clothing,false,2153874362292,0.00,1995.38,542279.09,Essential
3,23/12/2022,Industrial,true,2156143492489,2899.33,0.00,539379.76,Important
4,23/12/2022,Games,false,2003697616024,0.00,1532.03,540911.79,Non-Essential
5,23/12/2022,Clothing,true,2086344215661,2355.73,0.00,538556.06,Non-Essential
6,23/12/2022,Music,true,2490790716171,1973.11,0.00,536582.95,Essential
7,23/12/2022,Outdoors,true,2149767778002,2604.32,0.00,533978.63,Important
8,23/12/2022,Grocery,true,2016170275768,2910.13,0.00,531068.50,Essential
9,23/12/2022,Grocery,false,2096494119394,0.00,1794.64,532863.14,Non-Essential
10,23/12/2022,Health,false,2717243753532,0.00,2805.57,535668.71,Important
11,23/12/2022,Home,true,2694610074296,1295.42,0.00,534373.29,Essential
12,23/12/2022,Toys,true,2917605618306,1727.37,0.00,532645.92,Non-Essential
13,23/12/2022,Computers,false,2279594515245,0.00,2885.79,535531.71,Essential
14,23/12/2022,Beauty,false,2742918496447,0.00,2915.08,538446.79,Non-Essential
15,24/12/2022,Clothing,false,2153385917337,0.00,1948.11,540394.90,Non-Essential
16,24/12/2022,Grocery,true,2648207424484,1613.02,0.00,538781.88,Essential
17,24/12/2022,Books,true,2558846261879,2146.17,0.00,536635.71,Essential
18,24/12/2022,Baby,false,2222389139458,0.00,1622.53,538258.24,Essential
19,24/12/2022,Toys,false,2386456912918,0.00,748.71,539006.95,Non-Essential
20,24/12/2022,Baby,true,2584315428394,1180.67,0.00,537826.28,Important
21,24/12/2022,Music,false,2637505662152,0.00,1477.54,539303.82,Non-important
22,24/12/2022,Grocery,true,2779153463911,1587.59,0.00,537716.23,Essential
23,24/12/2022,Baby,true,2398953270555,2476.84,0.00,535239.39,Essential
24,24/12/2022,Computers,false,2656977692993,0.00,2428.52,537667.91,Non-important
25,25/12/2022,Beauty,true,2675891621283,2223.20,0.00,535444.71,Non-Essential
26,25/12/2022,Computers,true,2347662982315,2767.17,0.00,532677.54,Essential
27,25/12/2022,Clothing,false,2723733264201,0.00,487.94,533165.48,Essential
28,25/12/2022,Home,false,2759497587783,0.00,382.86,533548.34,Non-Essential
29,25/12/2022,Grocery,true,2796192848605,1151.53,0.00,532396.81,Non-Essential
30,25/12/2022,Garden,false,2697398488022,0.00,1887.36,534284.17,Non-important
31,25/12/2022,Games,false,2559095109473,0.00,2403.64,536687.81,Non-important
32,25/12/2022,Shoes,true,2039437836194,125.23,0.00,536562.58,Important
33,25/12/2022,Sports,false,2568479729707,0.00,2700.39,539262.97,Important
34,26/12/2022,Electronics,true,2610760950233,86.92,0.00,539176.05,Non-Essential
35,26/12/2022,Health,false,2886527654271,0.00,1319.34,540495.39,Essential
36,26/12/2022,Movies,true,2509912587299,1321.12,0.00,539174.27,Important
37,26/12/2022,Toys,true,2808436303656,2364.75,0.00,536809.52,Important
38,26/12/2022,Toys,false,2070118238933,0.00,1921.05,538730.57,Non-important
39,26/12/2022,Garden,true,2483572388693,1505.67,0.00,537224.90,Non-important
40,26/12/2022,Books,false,2869495816434,0.00,2324.52,539549.42,Non-Essential
41,26/12/2022,Toys,true,2986692250060,638.94,0.00,538910.48,Important
42,26/12/2022,Health,false,2042894788070,0.00,2875.25,541785.73,Non-important
43,26/12/2022,Shoes,false,2912935671461,0.00,738.51,542524.24,Important
44,26/12/2022,Electronics,false,2622860734042,0.00,18.57,542542.81,Important
45,26/12/2022,Books,false,2584896885126,0.00,2726.27,545269.08,Important
46,26/12/2022,Garden,true,2070663660643,2474.66,0.00,542794.42,Essential
47,27/12/2022,Shoes,false,2308507398134,0.00,10.25,542804.67,Important
48,27/12/2022,Tools,true,2208908283863,1794.02,0.00,541010.65,Essential
49,27/12/2022,Home,false,2907892820442,0.00,559.44,541570.09,Non-important
50,27/12/2022,Electronics,false,2866190384328,0.00,2839.41,544409.50,Important
51,27/12/2022,Toys,true,2614794895056,2169.98,0.00,542239.52,Essential
52,27/12/2022,Automotive,false,2369418564620,0.00,646.47,542885.99,Non-Essential
53,27/12/2022,Beauty,true,2522503055785,592.78,0.00,542293.21,Non-Essential
54,27/12/2022,Movies,false,2235552669844,0.00,471.87,542765.08,Important
55,27/12/2022,Health,true,2017935401247,736.61,0.00,542028.47,Non-Essential
56,27/12/2022,Computers,true,2618595427030,675.70,0.00,541352.77,Non-important
57,27/12/2022,Sports,true,2253800934074,965.63,0.00,540387.14,Essential
58,28/12/2022,Home,false,2914900616635,0.00,2554.39,542941.53,Non-important
59,28/12/2022,Shoes,false,2677750833801,0.00,923.28,543864.81,Non-Essential
60,28/12/2022,Health,false,2231310571669,0.00,2672.48,546537.29,Non-Essential
61,28/12/2022,Grocery,false,2018591525739,0.00,1306.30,547843.59,Important
62,28/12/2022,Movies,true,2750835063783,2345.12,0.00,545498.47,Essential
63,28/12/2022,Clothing,true,2810558129222,1505.93,0.00,543992.54,Non-important
64,29/12/2022,Baby,false,2850816627496,0.00,2460.17,546452.71,Non-Essential
65,29/12/2022,Health,false,2199043954834,0.00,1267.48,547720.19,Non-important
66,29/12/2022,Home,true,2007183525733,677.06,0.00,547043.13,Non-important
67,29/12/2022,Home,true,2768898532731,2482.76,0.00,544560.37,Important
68,29/12/2022,Health,false,2551979387326,0.00,818.03,545378.40,Non-Essential
69,29/12/2022,Toys,false,2088811338733,0.00,1301.44,546679.84,Important
70,29/12/2022,Garden,true,2938576078295,1948.57,0.00,544731.27,Essential
71,29/12/2022,Kids,true,2725578942031,2493.59,0.00,542237.68,Important
72,29/12/2022,Clothing,true,2194398294120,1080.01,0.00,541157.67,Non-important
73,29/12/2022,Industrial,true,2302051675327,127.46,0.00,541030.21,Non-Essential
74,29/12/2022,Games,false,2286952453506,0.00,2406.46,543436.67,Non-Essential
75,29/12/2022,Outdoors,false,2444827418995,0.00,1202.67,544639.34,Non-important
76,29/12/2022,Jewelry,true,2769666419844,813.49,0.00,543825.85,Non-important
77,30/12/2022,Movies,false,2213109215151,0.00,184.80,544010.65,Important
78,30/12/2022,Baby,true,2786517079270,308.81,0.00,543701.84,Essential
79,30/12/2022,Industrial,true,2763364784505,2541.52,0.00,541160.32,Important
80,30/12/2022,Home,false,2782374489949,0.00,1359.82,542520.14,Non-Essential
81,30/12/2022,Jewelry,false,2395098169918,0.00,142.92,542663.06,Non-important
82,30/12/2022,Outdoors,true,2717856117365,2170.90,0.00,540492.16,Important
83,30/12/2022,Books,true,2957542361553,2213.59,0.00,538278.57,Essential
84,30/12/2022,Electronics,true,2004450361664,93.68,0.00,538184.89,Important
85,30/12/2022,Shoes,true,2268156019016,206.51,0.00,537978.38,Important
86,31/12/2022,Health,false,2067908214974,0.00,1123.69,539102.07,Non-Essential
87,31/12/2022,Grocery,false,2998236209840,0.00,2461.01,541563.08,Non-Essential
88,31/12/2022,Garden,true,2699881246643,1178.78,0.00,540384.30,Non-Essential
89,31/12/2022,Books,true,2683615916286,2920.36,0.00,537463.94,Important
90,31/12/2022,Shoes,false,2699534235305,0.00,1866.31,539330.25,Non-important
91,31/12/2022,Shoes,true,2114810735360,2700.74,0.00,536629.51,Important
92,31/12/2022,Grocery,false,2124360884640,0.00,538.51,537168.02,Important
93,31/12/2022,Outdoors,true,2419869842103,1369.91,0.00,535798.11,Essential
94,31/12/2022,Home,true,2540706628813,1262.00,0.00,534536.11,Essential
95,31/12/2022,Baby,true,2529568856065,1147.09,0.00,533389.02,Important
96,01/01/2023,Music,false,2122470910014,0.00,2633.18,536022.20,Non-Essential
97,01/01/2023,Movies,false,2385173523650,0.00,718.67,536740.87,Important
98,01/01/2023,Books,true,2953040093153,111.06,0.00,536629.81,Essential
99,01/01/2023,Health,false,2109951307027,0.00,2861.79,539491.60,Essential
100,01/01/2023,Baby,true,2940273492509,2186.90,0.00,537304.70,Non-Essential
101,02/01/2023,Jewelry,true,2490902050173,2378.78,0.00,534925.92,Important
102,02/01/2023,Games,false,2609913227848,0.00,1944.01,536869.93,Non-Essential
103,02/01/2023,Shoes,false,2165529478978,0.00,2599.78,539469.71,Essential
104,02/01/2023,Automotive,false,2356244898745,0.00,1752.57,541222.28,Non-important
105,02/01/2023,Industrial,false,2078961940101,0.00,1838.83,543061.11,Non-Essential
106,02/01/2023,Electronics,true,2654619459318,440.32,0.00,542620.79,Important
107,02/01/2023,Industrial,true,2158540734758,415.59,0.00,542205.20,Essential
108,02/01/2023,Tools,false,2667964345738,0.00,2865.56,545070.76,Important
109,03/01/2023,Home,false,2225362163335,0.00,66.01,545136.77,Important
110,03/01/2023,Grocery,true,2328163904381,101.70,0.00,545035.07,Non-Essential
111,03/01/2023,Health,true,2023470964569,1017.98,0.00,544017.09,Essential
112,03/01/2023,Beauty,false,2759067571998,0.00,2226.92,546244.01,Essential
113,03/01/2023,Baby,false,2223106605264,0.00,160.49,546404.50,Non-Essential
114,03/01/2023,Beauty,false,2695972059976,0.00,717.31,547121.81,Important
115,03/01/2023,Beauty,true,2684143311350,1747.98,0.00,545373.83,Non-important
116,03/01/2023,Toys,true,2908499800544,1512.61,0.00,543861.22,Non-Essential
117,03/01/2023,Jewelry,false,2506375717646,0.00,2439.84,546301.06,Important
118,03/01/2023,Baby,false,2915699734987,0.00,250.42,546551.48,Important
119,03/01/2023,Sports,false,2670573724638,0.00,2504.16,549055.64,Non-Essential
120,03/01/2023,Games,false,2731432063634,0.00,850.44,549906.08,Essential
121,03/01/2023,Home,true,2111990763140,2659.00,0.00,547247.08,Important
122,03/01/2023,Movies,true,2657951080321,1987.90,0.00,545259.18,Important
123,03/01/2023,Tools,true,2552907218538,2719.75,0.00,542539.43,Non-Essential
124,04/01/2023,Beauty,true,2575029662379,97.93,0.00,542441.50,Non-Essential
125,04/01/2023,Toys,true,2271917905801,2291.50,0.00,540150.00,Non-important
126,04/01/2023,Kids,false,2970336564539,0.00,1706.25,541856.25,Non-Essential
127,04/01/2023,Baby,false,2923175726528,0.00,2081.56,543937.81,Non-important
128,04/01/2023,Jewelry,false,2091743004416,0.00,2397.23,546335.04,Non-important
129,04/01/2023,Outdoors,true,2299475014337,1937.98,0.00,544397.06,Non-important
130,04/01/2023,Shoes,true,2416567872957,893.82,0.00,543503.24,Important
131,04/01/2023,Shoes,true,2104643308263,1400.64,0.00,542102.60,Non-important
132,04/01/2023,Movies,true,2175599420231,730.54,0.00,541372.06,Essential
133,04/01/2023,Baby,false,2810147899289,0.00,1475.59,542847.65,Important
134,04/01/2023,Kids,false,2846602730378,0.00,1336.71,544184.36,Essential
135,04/01/2023,Beauty,true,2069794118136,1803.73,0.00,542380.63,Non-important
136,04/01/2023,Grocery,false,2376256231353,0.00,2892.20,545272.83,Essential
137,04/01/2023,Shoes,true,2514413238599,717.51,0.00,544555.32,Non-Essential
138,04/01/2023,Kids,true,2095329834298,1390.04,0.00,543165.28,Non-Essential
139,04/01/2023,Baby,true,2932644255896,2154.36,0.00,541010.92,Essential
140,04/01/2023,Tools,false,2608205507318,0.00,299.31,541310.23,Essential
141,04/01/2023,Sports,false,2472284019259,0.00,2779.37,544089.60,Non-Essential
142,05/01/2023,Grocery,true,2029857073390,2030.08,0.00,542059.52,Non-important
143,05/01/2023,Tools,true,2051673575868,414.78,0.00,541644.74,Important
144,05/01/2023,Shoes,true,2266059851349,2751.19,0.00,538893.55,Non-important
145,05/01/2023,Automotive,true,2412010032754,981.57,0.00,537911.98,Non-important
146,05/01/2023,Automotive,false,2486880121155,0.00,1311.22,539223.20,Non-Essential
147,05/01/2023,Health,false,2506929534646,0.00,2218.11,541441.31,Important
148,05/01/2023,Toys,false,2147184081520,0.00,1236.52,542677.83,Non-Essential
149,05/01/2023,Shoes,true,2336961671324,1408.44,0.00,541269.39,Non-important
150,05/01/2023,Music,false,2284441179584,0.00,1052.37,542321.76,Essential
151,05/01/2023,Games,false,2230031022531,0.00,2826.69,545148.45,Non-Essential
152,05/01/2023,Tools,true,2003171665185,2194.00,0.00,542954.45,Non-important
153,05/01/2023,Books,true,2298575100133,1655.17,0.00,541299.28,Non-Essential
154,05/01/2023,Electronics,true,2025702549875,141.32,0.00,541157.96,Essential
155,06/01/2023,Jewelry,true,2248446073939,2230.02,0.00,538927.94,Non-important
156,06/01/2023,Toys,true,2071249907601,1715.89,0.00,537212.05,Non-Essential
157,06/01/2023,Beauty,true,2247409770600,2810.28,0.00,534401.77,Important
158,06/01/2023,Baby,true,2206310994358,1895.15,0.00,532506.62,Essential
159,06/01/2023,Home,false,2256518850740,0.00,2803.29,535309.91,Essential
160,06/01/2023,Books,true,2216591695091,2376.89,0.00,532933.02,Important
161,06/01/2023,Shoes,false,2797926326218,0.00,537.89,533470.91,Important
162,06/01/2023,Sports,false,2028512243366,0.00,334.52,533805.43,Essential
163,06/01/2023,Home,false,2558990943293,0.00,1840.02,535645.45,Non-important
164,06/01/2023,Industrial,false,2419373184363,0.00,888.51,536533.96,Non-important
165,06/01/2023,Music,false,2943841148875,0.00,2763.68,539297.64,Non-important
166,06/01/2023,Books,true,2961383079846,2329.12,0.00,536968.52,Important
167,06/01/2023,Industrial,true,2272388766762,2596.46,0.00,534372.06,Essential
168,07/01/2023,Books,true,2438457453221,1314.04,0.00,533058.02,Non-important
169,07/01/2023,Shoes,false,2307023033084,0.00,190.68,533248.70,Non-important
170,07/01/2023,Automotive,false,2832814742243,0.00,2936.84,536185.54,Non-Essential
171,07/01/2023,Health,false,2563131576123,0.00,2406.62,538592.16,Non-important
172,07/01/2023,Home,false,2581312179308,0.00,1680.96,540273.12,Essential
173,07/01/2023,Outdoors,true,2499871180465,1267.47,0.00,539005.65,Important
174,07/01/2023,Computers,true,2778841784480,897.89,0.00,538107.76,Essential
175,07/01/2023,Health,false,2988324377148,0.00,2822.14,540929.90,Important
176,07/01/2023,Games,false,2729021891533,0.00,870.51,541800.41,Non-Essential
177,07/01/2023,Kids,true,2185671853404,1756.34,0.00,540044.07,Essential
178,07/01/2023,Movies,true,2891515086980,830.43,0.00,539213.64,Non-important
179,07/01/2023,Tools,true,2643230183412,1475.07,0.00,537738.57,Non-important
180,08/01/2023,Toys,true,2412380541457,1228.51,0.00,536510.06,Important
181,08/01/2023,Baby,true,2509154215480,934.42,0.00,535575.64,Important
182,08/01/2023,Jewelry,true,2361226166589,2940.62,0.00,532635.02,Non-important
183,08/01/2023,Games,true,2515359206800,1255.54,0.00,531379.48,Non-Essential
184,08/01/2023,Books,true,2145998544168,1548.65,0.00,529830.83,Non-Essential
185,08/01/2023,Automotive,true,2433762221627,2777.90,0.00,527052.93,Non-Essential
186,08/01/2023,Outdoors,true,2337261825665,1772.92,0.00,525280.01,Non-Essential
187,08/01/2023,Automotive,true,2063872983125,1751.00,0.00,523529.01,Non-important
188,08/01/2023,Garden,false,2311037909599,0.00,2586.66,526115.67,Important
189,08/01/2023,Electronics,true,2317038816532,2105.52,0.00,524010.15,Essential
190,08/01/2023,Outdoors,false,2413617989858,0.00,1110.42,525120.57,Essential
191,08/01/2023,Toys,false,2635952652247,0.00,1951.19,527071.76,Non-Essential
192,08/01/2023,Garden,true,2642360856793,917.41,0.00,526154.35,Non-Essential
193,09/01/2023,Computers,true,2906220816633,467.07,0.00,525687.28,Essential
194,09/01/2023,Computers,true,2090245866543,185.30,0.00,525501.98,Important
195,09/01/2023,Home,true,2120478005869,724.04,0.00,524777.94,Important
196,09/01/2023,Jewelry,true,2180938949754,1932.32,0.00,522845.62,Non-Essential
197,09/01/2023,Automotive,true,2285149970971,439.41,0.00,522406.21,Non-Essential
198,09/01/2023,Movies,true,2460648864654,1720.06,0.00,520686.15,Important
199,09/01/2023,Clothing,true,2788521512923,168.76,0.00,520517.39,Non-important
200,09/01/2023,Tools,false,2303299122313,0.00,2783.55,523300.94,Important
201,09/01/2023,Industrial,true,2648519105398,220.56,0.00,523080.38,Important
202,09/01/2023,Grocery,false,2236700508192,0.00,447.88,523528.26,Essential
203,09/01/2023,Baby,true,2152143640055,1466.81,0.00,522061.45,Essential
204,09/01/2023,Automotive,false,2592128535345,0.00,1947.23,524008.68,Non-important
205,09/01/2023,Outdoors,true,2208824236589,1124.19,0.00,522884.49,Non-important
206,10/01/2023,Automotive,true,2237404773983,973.08,0.00,521911.41,Essential
207,10/01/2023,Outdoors,true,2912881672789,932.68,0.00,520978.73,Essential
208,10/01/2023,Tools,false,2288539709112,0.00,542.07,521520.80,Non-Essential
209,10/01/2023,Clothing,true,2778829166631,568.63,0.00,520952.17,Non-Essential
210,10/01/2023,Clothing,false,2109707504797,0.00,1335.19,522287.36,Non-Essential
211,10/01/2023,Baby,false,2498568041965,0.00,1248.71,523536.07,Non-important
212,10/01/2023,Kids,false,2340042315673,0.00,2791.76,526327.83,Essential
213,11/01/2023,Clothing,true,2697295786596,510.34,0.00,525817.49,Essential
214,11/01/2023,Sports,false,2846428046887,0.00,1343.29,527160.78,Important
215,11/01/2023,Health,false,2711538924517,0.00,2425.70,529586.48,Non-important
216,11/01/2023,Tools,false,2806014300809,0.00,2355.45,531941.93,Important
217,11/01/2023,Health,false,2548126026658,0.00,1081.30,533023.23,Non-important
218,11/01/2023,Health,false,2765148465854,0.00,1543.70,534566.93,Non-important
219,11/01/2023,Electronics,true,2488391882091,2950.53,0.00,531616.40,Non-Essential
220,11/01/2023,Home,true,2756439065657,19.76,0.00,531596.64,Non-Essential
221,11/01/2023,Grocery,true,2152598114220,2455.22,0.00,529141.42,Non-important
222,12/01/2023,Shoes,true,2375906037828,421.57,0.00,528719.85,Essential
223,12/01/2023,Home,true,2829165331614,430.74,0.00,528289.11,Essential
224,12/01/2023,Electronics,true,2793337475641,2703.18,0.00,525585.93,Important
225,12/01/2023,Automotive,true,2072144428804,2525.05,0.00,523060.88,Important
226,12/01/2023,Sports,true,2817017911883,1776.66,0.00,521284.22,Non-Essential
227,12/01/2023,Computers,true,2928964906036,2704.41,0.00,518579.81,Important
228,12/01/2023,Games,false,2010068428573,0.00,665.49,519245.30,Important
229,12/01/2023,Music,false,2520761623362,0.00,2394.08,521639.38,Essential
230,12/01/2023,Garden,false,2995929609237,0.00,1590.05,523229.43,Important
231,12/01/2023,Sports,false,2219654222753,0.00,2636.20,525865.63,Essential
232,13/01/2023,Kids,true,2396435418457,1030.09,0.00,524835.54,Non-important
233,13/01/2023,Health,true,2140829463055,2263.76,0.00,522571.78,Non-important
234,13/01/2023,Electronics,false,2918456631132,0.00,2016.29,524588.07,Important
235,13/01/2023,Outdoors,true,2085495605281,1007.44,0.00,523580.63,Important
236,13/01/2023,Movies,false,2384505660306,0.00,59.95,523640.58,Non-important
237,13/01/2023,Beauty,true,2757306147372,635.28,0.00,523005.30,Important
238,13/01/2023,Movies,false,2763512954727,0.00,2714.61,525719.91,Non-important
239,13/01/2023,Toys,false,2499560469657,0.00,1803.92,527523.83,Important
240,13/01/2023,Jewelry,false,2592639342889,0.00,2704.97,530228.80,Non-Essential
241,13/01/2023,Health,false,2781112802063,0.00,2039.54,532268.34,Important
242,14/01/2023,Games,false,2112661404992,0.00,1642.13,533910.47,Non-Essential
243,14/01/2023,Shoes,true,2617246569747,549.57,0.00,533360.90,Important
244,14/01/2023,Movies,false,2600035840520,0.00,1658.86,535019.76,Essential
245,14/01/2023,Outdoors,false,2766509497782,0.00,1412.96,536432.72,Important
246,14/01/2023,Tools,false,2444953683316,0.00,333.36,536766.08,Non-important
247,14/01/2023,Automotive,false,2352619787355,0.00,1959.29,538725.37,Important
248,15/01/2023,Grocery,true,2393099839644,1740.73,0.00,536984.64,Non-Essential
249,15/01/2023,Clothing,true,2840777407041,2603.59,0.00,534381.05,Non-Essential
250,15/01/2023,Electronics,false,2870415024307,0.00,2216.64,536597.69,Important
251,15/01/2023,Jewelry,false,2371389271669,0.00,727.98,537325.67,Essential
252,15/01/2023,Movies,true,2533066495853,2574.14,0.00,534751.53,Essential
253,15/01/2023,Electronics,true,2722479831543,1425.11,0.00,533326.42,Non-important
254,15/01/2023,Toys,false,2627037854045,0.00,2147.36,535473.78,Non-Essential
255,15/01/2023,Jewelry,true,2284215437529,872.78,0.00,534601.00,Non-Essential
256,15/01/2023,Games,false,2516319570761,0.00,2000.63,536601.63,Important
257,15/01/2023,Toys,false,2877826483561,0.00,2588.25,539189.88,Non-Essential
258,15/01/2023,Home,true,2280610400547,1028.98,0.00,538160.90,Important
259,16/01/2023,Books,false,2642558762172,0.00,2346.08,540506.98,Non-important
260,16/01/2023,Home,true,2201468117806,1634.74,0.00,538872.24,Non-important
261,16/01/2023,Jewelry,true,2357849862420,2388.96,0.00,536483.28,Essential
262,16/01/2023,Beauty,true,2229665950981,2905.93,0.00,533577.35,Non-Essential
263,16/01/2023,Home,true,2640460966875,1408.37,0.00,532168.98,Essential
264,16/01/2023,Baby,true,2794123739795,2437.06,0.00,529731.92,Non-important
265,16/01/2023,Jewelry,true,2313880561672,568.16,0.00,529163.76,Non-Essential
266,16/01/2023,Garden,false,2542076690875,0.00,2214.91,531378.67,Important
267,16/01/2023,Sports,true,2442052566761,2277.96,0.00,529100.71,Non-Essential
268,16/01/2023,Kids,false,2865296195175,0.00,1898.67,530999.38,Important
269,16/01/2023,Games,false,2020418006406,0.00,2868.18,533867.56,Non-important
270,16/01/2023,Jewelry,true,2563152584915,1650.12,0.00,532217.44,Non-important
271,16/01/2023,Kids,false,2910932519744,0.00,2652.82,534870.26,Essential
272,17/01/2023,Health,true,2104121424241,1335.28,0.00,533534.98,Important
273,17/01/2023,Computers,true,2567488632987,705.14,0.00,532829.84,Non-important
274,17/01/2023,Sports,false,2435545723023,0.00,54.78,532884.62,Non-Essential
275,17/01/2023,Electronics,true,2351947349656,2839.94,0.00,530044.68,Essential
276,17/01/2023,Music,true,2774513516607,2095.40,0.00,527949.28,Important
277,17/01/2023,Baby,false,2912647479832,0.00,104.40,528053.68,Essential
278,17/01/2023,Computers,true,2690692442569,1560.11,0.00,526493.57,Essential
279,17/01/2023,Shoes,true,2608319957300,1138.30,0.00,525355.27,Non-important
280,17/01/2023,Music,false,2623087121539,0.00,726.67,526081.94,Non-important
281,18/01/2023,Shoes,false,2700501339518,0.00,966.81,527048.75,Non-Essential
282,18/01/2023,Automotive,true,2534529621114,1384.20,0.00,525664.55,Important
283,18/01/2023,Jewelry,false,2560955350204,0.00,1294.35,526958.90,Important
284,18/01/2023,Sports,true,2649469873377,1880.48,0.00,525078.42,Non-important
285,18/01/2023,Games,false,2207809659025,0.00,1384.85,526463.27,Essential
286,18/01/2023,Grocery,false,2157443602998,0.00,1528.50,527991.77,Important
287,18/01/2023,Tools,true,2709696098316,2443.16,0.00,525548.61,Non-Essential
288,18/01/2023,Jewelry,true,2524148977578,735.42,0.00,524813.19,Non-Essential
289,18/01/2023,Sports,true,2949867149918,1861.78,0.00,522951.41,Important
290,19/01/2023,Automotive,true,2444958084265,65.02,0.00,522886.39,Important
291,19/01/2023,Electronics,false,2127919481632,0.00,2169.35,525055.74,Important
292,19/01/2023,Beauty,true,2860847001904,2737.44,0.00,522318.30,Essential
293,19/01/2023,Garden,false,2682138905128,0.00,1989.52,524307.82,Important
294,19/01/2023,Music,true,2599699378512,892.87,0.00,523414.95,Important
295,19/01/2023,Computers,false,2867277136988,0.00,618.23,524033.18,Essential
296,19/01/2023,Kids,false,2097747169798,0.00,628.93,524662.11,Important
297,19/01/2023,Tools,true,2578397899068,913.95,0.00,523748.16,Non-important
298,19/01/2023,Clothing,true,2119776309954,737.23,0.00,523010.93,Important
299,19/01/2023,Grocery,true,2192034104312,1961.20,0.00,521049.73,Non-Essential
300,19/01/2023,Electronics,true,2162286387881,2080.96,0.00,518968.77,Non-Essential
301,19/01/2023,Books,true,2302057460979,1349.49,0.00,517619.28,Important
302,20/01/2023,Computers,true,2848918535218,2981.94,0.00,514637.34,Non-important
303,20/01/2023,Baby,true,2999993196732,865.31,0.00,513772.03,Essential
304,20/01/2023,Baby,true,2745036853567,1182.51,0.00,512589.52,Non-Essential
305,20/01/2023,Outdoors,true,2837031311766,1971.03,0.00,510618.49,Non-Essential
306,20/01/2023,Outdoors,false,2818512155463,0.00,788.12,511406.61,Non-Essential
307,20/01/2023,Industrial,false,2014244166226,0.00,2136.89,513543.50,Important
308,20/01/2023,Shoes,true,2674658127202,2103.07,0.00,511440.43,Non-Essential
309,20/01/2023,Books,false,2826799141996,0.00,1916.53,513356.96,Non-important
310,20/01/2023,Health,true,2004841752898,2428.27,0.00,510928.69,Non-Essential
311,20/01/2023,Baby,true,2236760677160,439.98,0.00,510488.71,Non-Essential
312,21/01/2023,Music,true,2615732589751,522.58,0.00,509966.13,Non-Essential
313,21/01/2023,Industrial,false,2006393143692,0.00,1841.74,511807.87,Non-important
314,21/01/2023,Kids,false,2745845603403,0.00,1396.92,513204.79,Non-Essential
315,21/01/2023,Movies,false,2614601816552,0.00,2622.42,515827.21,Essential
316,21/01/2023,Tools,false,2714851550409,0.00,817.51,516644.72,Important
317,21/01/2023,Kids,true,2792672631733,795.45,0.00,515849.27,Non-Essential
318,22/01/2023,Movies,true,2211480188284,785.34,0.00,515063.93,Essential
319,22/01/2023,Tools,true,2103846974319,246.46,0.00,514817.47,Non-important
320,22/01/2023,Outdoors,true,2733672634541,749.31,0.00,514068.16,Important
321,22/01/2023,Garden,true,2641142789285,663.95,0.00,513404.21,Essential
322,22/01/2023,Home,false,2073707173277,0.00,2405.58,515809.79,Non-important
323,22/01/2023,Books,false,2413700918492,0.00,1933.51,517743.30,Important
324,22/01/2023,Industrial,true,2300139479478,2246.14,0.00,515497.16,Non-Essential
325,22/01/2023,Baby,true,2233213040139,2413.79,0.00,513083.37,Important
326,22/01/2023,Books,false,2238564392039,0.00,277.65,513361.02,Important
327,22/01/2023,Garden,false,2269837084597,0.00,212.30,513573.32,Important
328,22/01/2023,Games,true,2970932150901,2554.16,0.00,511019.16,Important
329,22/01/2023,Toys,true,2475993638281,2148.68,0.00,508870.48,Important
330,22/01/2023,Sports,false,2258820572747,0.00,1164.87,510035.35,Essential
331,22/01/2023,Sports,false,2022212078552,0.00,2441.43,512476.78,Essential
332,22/01/2023,Games,false,2090049147343,0.00,1108.33,513585.11,Important
333,22/01/2023,Automotive,true,2829729652266,2283.58,0.00,511301.53,Non-Essential
334,23/01/2023,Garden,false,2275073620069,0.00,1346.71,512648.24,Non-important
335,23/01/2023,Garden,true,2733349715024,2318.88,0.00,510329.36,Non-Essential
336,23/01/2023,Grocery,false,2605294346818,0.00,2416.20,512745.56,Non-Essential
337,23/01/2023,Toys,true,2276068812750,1030.20,0.00,511715.36,Non-important
338,23/01/2023,Games,false,2321342739152,0.00,1458.69,513174.05,Essential
339,23/01/2023,Sports,false,2573001972152,0.00,204.67,513378.72,Non-important
340,23/01/2023,Kids,false,2731388491325,0.00,1330.60,514709.32,Important
341,23/01/2023,Beauty,true,2883098763897,1860.96,0.00,512848.36,Non-Essential
342,23/01/2023,Grocery,false,2401997606506,0.00,945.19,513793.55,Non-important
343,23/01/2023,Industrial,true,2007743061828,233.91,0.00,513559.64,Non-Essential
344,23/01/2023,Computers,true,2451131240225,2362.52,0.00,511197.12,Non-important
345,23/01/2023,Kids,false,2682677036288,0.00,1760.39,512957.51,Non-Essential
346,23/01/2023,Kids,true,2943597713161,9.81,0.00,512947.70,Important
347,23/01/2023,Shoes,false,2509067628587,0.00,981.90,513929.60,Important
348,24/01/2023,Industrial,true,2298411538974,2454.83,0.00,511474.77,Non-Essential
349,24/01/2023,Beauty,false,2994853772518,0.00,334.97,511809.74,Essential
350,24/01/2023,Health,false,2292331830081,0.00,1601.31,513411.05,Essential
351,24/01/2023,Electronics,true,2193060833194,1559.92,0.00,511851.13,Non-Essential
352,24/01/2023,Outdoors,false,2787474586829,0.00,2000.94,513852.07,Non-Essential
353,24/01/2023,Baby,true,2781355656509,2389.65,0.00,511462.42,Non-Essential
354,24/01/2023,Books,false,2939721468069,0.00,886.10,512348.52,Non-important
355,24/01/2023,Grocery,true,2520407806484,1096.30,0.00,511252.22,Important
356,24/01/2023,Grocery,true,2957521264851,2782.07,0.00,508470.15,Non-important
357,25/01/2023,Beauty,false,2234598094033,0.00,2485.66,510955.81,Important
358,25/01/2023,Health,false,2547199207179,0.00,1762.92,512718.73,Essential
359,25/01/2023,Movies,true,2689492049515,48.26,0.00,512670.47,Non-important
360,25/01/2023,Automotive,true,2177339818589,2502.65,0.00,510167.82,Non-important
361,25/01/2023,Industrial,true,2984467395588,953.21,0.00,509214.61,Non-Essential
362,25/01/2023,Kids,true,2468301537998,2250.58,0.00,506964.03,Non-important
363,25/01/2023,Health,true,2378913483005,621.56,0.00,506342.47,Important
364,25/01/2023,Clothing,false,2782734593082,0.00,903.68,507246.15,Important
365,25/01/2023,Jewelry,false,2236387704478,0.00,1018.79,508264.94,Non-Essential
366,25/01/2023,Electronics,true,2328663925937,446.78,0.00,507818.16,Essential
367,25/01/2023,Beauty,true,2437315636836,77.28,0.00,507740.88,Essential
368,26/01/2023,Kids,true,2582921773831,747.60,0.00,506993.28,Important
369,26/01/2023,Tools,false,2522710072521,0.00,1385.12,508378.40,Important
370,26/01/2023,Shoes,true,2333637644168,115.69,0.00,508262.71,Non-important
371,26/01/2023,Sports,true,2673437933039,1063.42,0.00,507199.29,Essential
372,26/01/2023,Kids,true,2142659541748,1022.46,0.00,506176.83,Non-important
373,26/01/2023,Home,false,2468816592812,0.00,1076.60,507253.43,Non-Essential
374,27/01/2023,Tools,true,2022785734744,561.50,0.00,506691.93,Essential
375,27/01/2023,Automotive,true,2837880907792,2035.89,0.00,504656.04,Non-important
376,27/01/2023,Books,true,2305184746957,202.56,0.00,504453.48,Non-Essential
377,27/01/2023,Kids,false,2745731844580,0.00,1093.93,505547.41,Non-important
378,27/01/2023,Grocery,false,2808604701033,0.00,1602.72,507150.13,Non-Essential
379,27/01/2023,Electronics,true,2570710721816,401.11,0.00,506749.02,Essential
380,27/01/2023,Grocery,false,2768616787533,0.00,1564.01,508313.03,Non-important
381,27/01/2023,Movies,true,2356697611898,1189.77,0.00,507123.26,Essential
382,27/01/2023,Home,true,2288688471385,1669.19,0.00,505454.07,Non-Essential
383,27/01/2023,Health,false,2522487843183,0.00,1193.70,506647.77,Essential
384,27/01/2023,Clothing,true,2696923222508,1503.72,0.00,505144.05,Essential
385,27/01/2023,Games,false,2585253830600,0.00,1501.55,506645.60,Non-important
386,27/01/2023,Grocery,false,2762478519487,0.00,608.53,507254.13,Non-important
387,28/01/2023,Kids,true,2228715543874,2681.17,0.00,504572.96,Essential
388,28/01/2023,Beauty,true,2037584189292,9.45,0.00,504563.51,Non-important
389,28/01/2023,Home,true,2807638347452,160.82,0.00,504402.69,Non-important
390,28/01/2023,Garden,false,2384472239984,0.00,1308.56,505711.25,Non-important
391,28/01/2023,Automotive,false,2395650023316,0.00,1880.01,507591.26,Important
392,28/01/2023,Clothing,true,2354061606259,1380.30,0.00,506210.96,Essential
393,28/01/2023,Games,true,2786483948543,736.96,0.00,505474.00,Non-Essential
394,28/01/2023,Home,false,2532537084062,0.00,707.79,506181.79,Non-Essential
395,28/01/2023,Books,false,2072640571106,0.00,475.14,506656.93,Essential
396,28/01/2023,Games,false,2794583265677,0.00,2953.28,509610.21,Important
397,28/01/2023,Automotive,true,2981758125664,1650.79,0.00,507959.42,Non-important
398,29/01/2023,Toys,false,2986008545019,0.00,2045.96,510005.38,Important
399,29/01/2023,Automotive,false,2497495605275,0.00,1635.01,511640.39,Non-important
400,29/01/2023,Baby,true,2588670804952,863.72,0.00,510776.67,Important
401,29/01/2023,Music,false,2087996245924,0.00,921.27,511697.94,Non-important
402,29/01/2023,Industrial,true,2036658914385,421.08,0.00,511276.86,Non-important
403,29/01/2023,Industrial,true,2027408382074,1949.70,0.00,509327.16,Essential
404,29/01/2023,Movies,false,2552271053569,0.00,447.76,509774.92,Non-Essential
405,29/01/2023,Shoes,true,2669349459559,142.95,0.00,509631.97,Non-Essential
406,29/01/2023,Sports,false,2951329892439,0.00,1071.41,510703.38,Non-important
407,29/01/2023,Kids,true,2963858331561,471.70,0.00,510231.68,Essential
408,29/01/2023,Beauty,false,2829307286371,0.00,2572.93,512804.61,Important
409,30/01/2023,Health,false,2911645299090,0.00,2868.73,515673.34,Important
410,30/01/2023,Movies,true,2126907643258,1839.49,0.00,513833.85,Essential
411,30/01/2023,Sports,true,2128389922439,1187.37,0.00,512646.48,Non-Essential
412,30/01/2023,Kids,true,2975105600497,1420.14,0.00,511226.34,Essential
413,30/01/2023,Music,true,2563161389593,780.64,0.00,510445.70,Essential
414,30/01/2023,Beauty,true,2775601163769,317.24,0.00,510128.46,Non-Essential
415,30/01/2023,Kids,true,2846375807375,1961.72,0.00,508166.74,Non-important
416,30/01/2023,Health,false,2250756987963,0.00,2154.34,510321.08,Essential
417,31/01/2023,Books,false,2087074512865,0.00,1038.60,511359.68,Important
418,31/01/2023,Sports,false,2752352791076,0.00,1101.97,512461.65,Essential
419,31/01/2023,Garden,false,2118389842259,0.00,1331.22,513792.87,Non-Essential
420,31/01/2023,Computers,true,2783832170571,1145.40,0.00,512647.47,Non-Essential
421,31/01/2023,Grocery,false,2889705940603,0.00,2411.45,515058.92,Essential
422,31/01/2023,Home,false,2579475234901,0.00,1969.10,517028.02,Essential
423,31/01/2023,Garden,false,2548968578273,0.00,157.74,517185.76,Important
424,31/01/2023,Toys,true,2047429360801,199.43,0.00,516986.33,Important
425,31/01/2023,Home,false,2115297891793,0.00,465.89,517452.22,Essential
426,31/01/2023,Tools,true,2622980550773,166.89,0.00,517285.33,Non-important
427,01/02/2023,Electronics,true,2289432106857,493.19,0.00,516792.14,Non-important
428,01/02/2023,Health,false,2081465538338,0.00,2299.12,519091.26,Essential
429,01/02/2023,Computers,true,2610266018961,741.52,0.00,518349.74,Non-Essential
430,01/02/2023,Games,true,2114471951369,1835.06,0.00,516514.68,Non-important
431,01/02/2023,Kids,false,2946646495606,0.00,922.85,517437.53,Essential
432,01/02/2023,Clothing,true,2505353895852,2709.05,0.00,514728.48,Important
433,01/02/2023,Garden,true,2269580269496,1425.16,0.00,513303.32,Non-important
434,01/02/2023,Health,true,2241627741719,852.60,0.00,512450.72,Non-important
435,01/02/2023,Garden,false,2965638143504,0.00,1094.06,513544.78,Non-important
436,01/02/2023,Beauty,true,2003444057002,936.71,0.00,512608.07,Non-important
437,01/02/2023,Grocery,false,2877607506753,0.00,2199.63,514807.70,Non-important
438,01/02/2023,Sports,true,2066342945633,850.71,0.00,513956.99,Non-Essential
439,01/02/2023,Music,false,2476548494333,0.00,2656.69,516613.68,Essential
440,01/02/2023,Automotive,false,2831657504055,0.00,2636.09,519249.77,Important
441,01/02/2023,Music,true,2970392522430,2434.73,0.00,516815.04,Essential
442,02/02/2023,Music,false,2186478884956,0.00,1504.07,518319.11,Essential
443,02/02/2023,Garden,false,2354720480252,0.00,2667.66,520986.77,Non-important
444,02/02/2023,Beauty,true,2154411487795,866.08,0.00,520120.69,Non-important
445,02/02/2023,Grocery,true,2113549945475,1481.82,0.00,518638.87,Non-important
446,02/02/2023,Toys,false,2243037306499,0.00,614.12,519252.99,Non-Essential
447,02/02/2023,Outdoors,true,2866686511840,531.66,0.00,518721.33,Essential
448,02/02/2023,Toys,true,2880924794895,1624.86,0.00,517096.47,Important
449,02/02/2023,Games,false,2654511305207,0.00,1158.94,518255.41,Essential
450,02/02/2023,Computers,false,2137746032842,0.00,1993.68,520249.09,Essential
451,02/02/2023,Computers,true,2914093366926,2004.83,0.00,518244.26,Non-important
452,02/02/2023,Garden,true,2454721599209,1748.62,0.00,516495.64,Important
453,03/02/2023,Games,true,2370116528072,2296.38,0.00,514199.26,Non-important
454,03/02/2023,Clothing,false,2398340531147,0.00,675.98,514875.24,Important
455,03/02/2023,Kids,false,2410089339355,0.00,1931.76,516807.00,Important
456,03/02/2023,Electronics,false,2539855203403,0.00,5.38,516812.38,Non-Essential
457,03/02/2023,Shoes,true,2513016284005,320.70,0.00,516491.68,Essential
458,03/02/2023,Industrial,true,2310676911659,2050.79,0.00,514440.89,Important
459,03/02/2023,Jewelry,false,2027184401760,0.00,277.12,514718.01,Essential
460,03/02/2023,Tools,false,2952667735924,0.00,1757.70,516475.71,Non-Essential
461,03/02/2023,Beauty,false,2993337301624,0.00,1007.89,517483.60,Essential
462,03/02/2023,Automotive,false,2936942498578,0.00,2652.09,520135.69,Essential
463,03/02/2023,Grocery,true,2100122913029,892.82,0.00,519242.87,Non-Essential
464,03/02/2023,Shoes,true,2654564032539,1224.78,0.00,518018.09,Important
465,03/02/2023,Clothing,true,2925382868064,473.55,0.00,517544.54,Non-important
466,03/02/2023,Health,true,2848741408041,1562.93,0.00,515981.61,Essential
467,03/02/2023,Music,true,2950704231649,1716.45,0.00,514265.16,Non-Essential
468,03/02/2023,Computers,true,2154908448193,1110.11,0.00,513155.05,Essential
469,03/02/2023,Industrial,true,2098547394495,1848.23,0.00,511306.82,Non-important
470,03/02/2023,Outdoors,true,2274467279624,1284.11,0.00,510022.71,Essential
471,03/02/2023,Home,true,2051246414476,388.20,0.00,509634.51,Essential
472,04/02/2023,Music,true,2517400602324,2207.20,0.00,507427.31,Non-Essential
473,04/02/2023,Computers,true,2194911366985,79.68,0.00,507347.63,Essential
474,04/02/2023,Jewelry,true,2501057677847,1399.04,0.00,505948.59,Non-Essential
475,04/02/2023,Industrial,false,2414546199464,0.00,1124.43,507073.02,Non-important
476,04/02/2023,Jewelry,true,2877153943503,1545.61,0.00,505527.41,Essential
477,04/02/2023,Tools,true,2952446881777,1056.14,0.00,504471.27,Non-Essential
478,04/02/2023,Shoes,false,2198609155050,0.00,1726.40,506197.67,Non-important
479,04/02/2023,Music,false,2054339060361,0.00,184.97,506382.64,Non-important
480,04/02/2023,Baby,false,2847409690088,0.00,1625.99,508008.63,Essential
481,04/02/2023,Toys,false,2550177181785,0.00,64.72,508073.35,Important
482,04/02/2023,Jewelry,false,2950988103117,0.00,260.32,508333.67,Essential
483,05/02/2023,Movies,true,2567301366199,438.34,0.00,507895.33,Non-important
484,05/02/2023,Garden,false,2755314131567,0.00,20.32,507915.65,Important
485,05/02/2023,Baby,true,2740419370013,698.15,0.00,507217.50,Non-Essential
486,05/02/2023,Automotive,false,2275460069371,0.00,1962.50,509180.00,Important
487,05/02/2023,Jewelry,false,2938814015208,0.00,391.39,509571.39,Essential
488,05/02/2023,Clothing,true,2802252488276,955.73,0.00,508615.66,Important
489,05/02/2023,Health,true,2865544680379,778.62,0.00,507837.04,Non-important
490,05/02/2023,Toys,false,2551658542459,0.00,1077.93,508914.97,Essential
491,05/02/2023,Grocery,false,2881847053884,0.00,1490.91,510405.88,Important
492,05/02/2023,Automotive,true,2926181536803,1985.81,0.00,508420.07,Important
493,06/02/2023,Automotive,false,2586620021772,0.00,2622.87,511042.94,Important
494,06/02/2023,Automotive,false,2388238204331,0.00,365.78,511408.72,Non-important
495,06/02/2023,Electronics,false,2624940577309,0.00,1459.32,512868.04,Non-Essential
496,06/02/2023,Home,false,2155946484334,0.00,194.11,513062.15,Essential
497,06/02/2023,Garden,true,2608503714720,1980.21,0.00,511081.94,Important
498,06/02/2023,Jewelry,true,2707526700533,609.84,0.00,510472.10,Non-Essential
499,06/02/2023,Games,true,2006758253044,693.70,0.00,509778.40,Non-Essential
500,06/02/2023,Home,true,2656252163255,827.75,0.00,508950.65,Important
501,06/02/2023,Books,true,2313834412915,1988.59,0.00,506962.06,Important
502,06/02/2023,Health,false,2058535605152,0.00,2311.73,509273.79,Non-important
503,06/02/2023,Movies,false,2985799430682,0.00,2033.76,511307.55,Essential
504,06/02/2023,Games,false,2673542072782,0.00,1850.20,513157.75,Non-important
505,07/02/2023,Health,true,2688169651251,832.66,0.00,512325.09,Important
506,07/02/2023,Tools,false,2882969558460,0.00,1093.85,513418.94,Important
507,07/02/2023,Computers,true,2028928840118,2226.79,0.00,511192.15,Non-Essential
508,07/02/2023,Music,false,2336982830611,0.00,910.86,512103.01,Essential
509,07/02/2023,Music,true,2095136415468,973.04,0.00,511129.97,Non-important
510,07/02/2023,Clothing,false,2623170159681,0.00,796.23,511926.20,Non-important
511,07/02/2023,Beauty,false,2699125596797,0.00,1038.07,512964.27,Non-important
512,07/02/2023,Movies,true,2858292359125,2270.85,0.00,510693.42,Non-important
513,07/02/2023,Music,true,2919761861003,2032.96,0.00,508660.46,Essential
514,07/02/2023,Industrial,true,2050173676474,2215.12,0.00,506445.34,Non-important
515,07/02/2023,Books,true,2252126045025,1479.85,0.00,504965.49,Non-Essential
516,07/02/2023,Computers,false,2978542781890,0.00,2341.58,507307.07,Non-important
517,07/02/2023,Movies,false,2612383619648,0.00,439.43,507746.50,Non-important
518,07/02/2023,Kids,false,2630183732639,0.00,2252.81,509999.31,Important
519,07/02/2023,Clothing,false,2639751617793,0.00,2580.28,512579.59,Non-Essential
520,07/02/2023,Movies,true,2165949283618,943.91,0.00,511635.68,Important
521,07/02/2023,Music,false,2973350957371,0.00,285.51,511921.19,Important
522,08/02/2023,Electronics,true,2396584938425,2319.98,0.00,509601.21,Non-important
523,08/02/2023,Outdoors,false,2746348884130,0.00,202.40,509803.61,Important
524,08/02/2023,Kids,false,2925204012413,0.00,2709.32,512512.93,Non-Essential
525,08/02/2023,Movies,true,2101435329993,2395.10,0.00,510117.83,Essential
526,08/02/2023,Beauty,false,2699930007397,0.00,1893.20,512011.03,Important
527,09/02/2023,Computers,false,2632097722653,0.00,816.03,512827.06,Non-important
528,09/02/2023,Electronics,true,2945893801266,774.28,0.00,512052.78,Non-Essential
529,09/02/2023,Games,true,2191320169377,637.62,0.00,511415.16,Important
530,09/02/2023,Sports,false,2869963697036,0.00,982.37,512397.53,Important
531,09/02/2023,Music,false,2674291859505,0.00,2496.33,514893.86,Important
532,09/02/2023,Movies,true,2372024840036,790.56,0.00,514103.30,Non-important
533,10/02/2023,Books,true,2867918089972,2381.57,0.00,511721.73,Non-Essential
534,10/02/2023,Garden,true,2704900143643,2076.19,0.00,509645.54,Important
535,10/02/2023,Home,false,2699310569344,0.00,2156.98,511802.52,Non-important
536,10/02/2023,Health,false,2754327083838,0.00,2664.89,514467.41,Non-Essential
537,10/02/2023,Home,true,2143949721600,945.27,0.00,513522.14,Important
538,10/02/2023,Garden,false,2524543087186,0.00,2078.19,515600.33,Important
539,10/02/2023,Outdoors,false,2854712733297,0.00,1073.38,516673.71,Important
540,10/02/2023,Books,false,2937165498127,0.00,338.90,517012.61,Important
541,11/02/2023,Automotive,true,2768944525042,2361.02,0.00,514651.59,Non-important
542,11/02/2023,Industrial,false,2817557370311,0.00,594.98,515246.57,Non-Essential
543,11/02/2023,Automotive,true,2455314687440,395.38,0.00,514851.19,Non-important
544,11/02/2023,Sports,true,2497195827344,2965.66,0.00,511885.53,Important
545,11/02/2023,Tools,false,2153475540476,0.00,2151.83,514037.36,Non-important
546,11/02/2023,Clothing,true,2627698756515,1596.36,0.00,512441.00,Non-important
547,11/02/2023,Grocery,true,2508552636976,1366.88,0.00,511074.12,Non-important
548,11/02/2023,Movies,false,2155785846528,0.00,813.67,511887.79,Important
549,11/02/2023,Computers,false,2959065785659,0.00,2120.57,514008.36,Non-Essential
550,11/02/2023,Outdoors,false,2564228845369,0.00,2070.76,516079.12,Essential
551,12/02/2023,Beauty,true,2794796125467,308.38,0.00,515770.74,Non-Essential
552,12/02/2023,Garden,true,2677997665752,343.17,0.00,515427.57,Important
553,12/02/2023,Music,true,2501771722677,2753.14,0.00,512674.43,Essential
554,12/02/2023,Games,true,2494277084003,1508.70,0.00,511165.73,Essential
555,12/02/2023,Computers,false,2436669649417,0.00,1268.03,512433.76,Non-Essential
556,12/02/2023,Kids,true,2804918396894,1094.26,0.00,511339.50,Important
557,12/02/2023,Clothing,false,2689627099941,0.00,2403.18,513742.68,Essential
558,12/02/2023,Automotive,true,2219898814997,464.97,0.00,513277.71,Non-Essential
559,12/02/2023,Tools,true,2570042838340,1060.27,0.00,512217.44,Non-Essential
560,12/02/2023,Baby,false,2756703285547,0.00,194.41,512411.85,Important
561,12/02/2023,Outdoors,false,2713655484275,0.00,810.69,513222.54,Non-important
562,12/02/2023,Automotive,true,2674400566325,2873.27,0.00,510349.27,Important
563,12/02/2023,Industrial,true,2263865467902,2212.40,0.00,508136.87,Non-important
564,13/02/2023,Outdoors,true,2425205235182,2946.42,0.00,505190.45,Essential
565,13/02/2023,Beauty,true,2992027122829,616.49,0.00,504573.96,Non-important
566,13/02/2023,Computers,false,2817974335691,0.00,946.89,505520.85,Important
567,13/02/2023,Automotive,true,2970868214716,2356.32,0.00,503164.53,Non-important
568,13/02/2023,Toys,false,2206782865979,0.00,1228.11,504392.64,Non-Essential
569,13/02/2023,Garden,false,2844287099256,0.00,2152.83,506545.47,Non-Essential
570,13/02/2023,Shoes,true,2284014265586,712.83,0.00,505832.64,Essential
571,13/02/2023,Outdoors,false,2513753059765,0.00,132.29,505964.93,Essential
572,13/02/2023,Computers,true,2419357063778,2395.50,0.00,503569.43,Non-important
573,13/02/2023,Beauty,false,2008903374530,0.00,998.70,504568.13,Non-important
574,13/02/2023,Beauty,false,2040330589064,0.00,1799.75,506367.88,Non-important
575,14/02/2023,Baby,false,2804360218092,0.00,306.38,506674.26,Non-Essential
576,14/02/2023,Home,false,2810078134396,0.00,138.03,506812.29,Important
577,14/02/2023,Movies,true,2561477765277,558.31,0.00,506253.98,Non-Essential
578,14/02/2023,Games,false,2582121472960,0.00,33.51,506287.49,Non-important
579,14/02/2023,Music,true,2643137322006,1300.35,0.00,504987.14,Non-Essential
580,14/02/2023,Tools,false,2006441339716,0.00,74.39,505061.53,Essential
581,15/02/2023,Music,false,2510280890723,0.00,530.06,505591.59,Non-important
582,15/02/2023,Toys,false,2319193295792,0.00,877.02,506468.61,Essential
583,15/02/2023,Computers,false,2255898293209,0.00,508.43,506977.04,Important
584,15/02/2023,Automotive,false,2099599892816,0.00,161.81,507138.85,Important
585,15/02/2023,Electronics,false,2431397358431,0.00,1091.52,508230.37,Non-important
586,15/02/2023,Tools,false,2102463903535,0.00,1339.87,509570.24,Non-important
587,15/02/2023,Beauty,false,2105733199958,0.00,762.33,510332.57,Essential
588,15/02/2023,Tools,false,2378294503035,0.00,1500.37,511832.94,Essential
589,15/02/2023,Clothing,true,2455520327880,599.21,0.00,511233.73,Non-Essential
590,15/02/2023,Industrial,true,2877882811424,1984.25,0.00,509249.48,Important
591,15/02/2023,Books,false,2533272528808,0.00,756.57,510006.05,Non-important
592,15/02/2023,Beauty,true,2817754161632,1439.76,0.00,508566.29,Non-Essential
593,15/02/2023,Home,false,2364646968636,0.00,183.53,508749.82,Non-important
594,15/02/2023,Jewelry,true,2615786275144,342.60,0.00,508407.22,Non-Essential
595,15/02/2023,Computers,true,2361680436394,2217.02,0.00,506190.20,Non-important
596,16/02/2023,Sports,true,2068800935290,1612.82,0.00,504577.38,Essential
597,16/02/2023,Automotive,false,2986343411660,0.00,1706.81,506284.19,Non-important
598,16/02/2023,Beauty,false,2120006626275,0.00,488.16,506772.35,Important
599,16/02/2023,Music,true,2864731057906,1145.42,0.00,505626.93,Non-Essential
600,16/02/2023,Grocery,true,2613243767744,14.35,0.00,505612.58,Essential
601,16/02/2023,Toys,false,2857318268951,0.00,545.04,506157.62,Essential
602,16/02/2023,Automotive,true,2416793163559,2805.41,0.00,503352.21,Non-Essential
603,16/02/2023,Home,true,2577180276510,2055.18,0.00,501297.03,Non-important
604,16/02/2023,Sports,false,2384667237124,0.00,2122.38,503419.41,Non-Essential
605,16/02/2023,Electronics,true,2733541700763,2276.62,0.00,501142.79,Important
606,16/02/2023,Toys,true,2238537881038,59.64,0.00,501083.15,Non-Essential
607,16/02/2023,Kids,false,2292995993581,0.00,2371.69,503454.84,Non-important
608,17/02/2023,Home,false,2422827924317,0.00,2387.14,505841.98,Important
609,17/02/2023,Jewelry,true,2038782998822,1307.56,0.00,504534.42,Important
610,17/02/2023,Jewelry,false,2720723648850,0.00,116.42,504650.84,Non-Essential
611,17/02/2023,Sports,true,2275038601095,407.19,0.00,504243.65,Essential
612,17/02/2023,Grocery,true,2644743345269,2456.85,0.00,501786.80,Non-Essential
613,17/02/2023,Toys,false,2816490933664,0.00,459.01,502245.81,Non-important
614,17/02/2023,Games,true,2150272391793,1951.34,0.00,500294.47,Non-Essential
615,17/02/2023,Electronics,false,2327963944391,0.00,842.38,501136.85,Non-Essential
616,17/02/2023,Electronics,false,2348398086704,0.00,2188.99,503325.84,Important
617,18/02/2023,Automotive,false,2789643091032,0.00,146.81,503472.65,Essential
618,18/02/2023,Automotive,false,2192837568681,0.00,1187.52,504660.17,Non-Essential
619,18/02/2023,Industrial,true,2882041189959,181.01,0.00,504479.16,Essential
620,18/02/2023,Baby,true,2811387806795,1134.01,0.00,503345.15,Important
621,18/02/2023,Toys,false,2293593173010,0.00,2813.46,506158.61,Important
622,18/02/2023,Computers,false,2806256748006,0.00,1012.32,507170.93,Essential
623,18/02/2023,Electronics,false,2933625220568,0.00,1558.64,508729.57,Essential
624,18/02/2023,Music,true,2374698191123,817.25,0.00,507912.32,Important
625,18/02/2023,Shoes,true,2512615129201,1095.91,0.00,506816.41,Non-important
626,18/02/2023,Books,false,2734751910089,0.00,1981.38,508797.79,Important
627,18/02/2023,Garden,true,2404226359059,1927.45,0.00,506870.34,Essential
628,18/02/2023,Outdoors,false,2256070568329,0.00,2619.50,509489.84,Non-important
629,18/02/2023,Clothing,false,2049160341047,0.00,1745.65,511235.49,Essential
630,18/02/2023,Games,false,2982173165186,0.00,1891.89,513127.38,Essential
631,18/02/2023,Jewelry,false,2083367192427,0.00,1254.58,514381.96,Important
632,18/02/2023,Computers,false,2792404064926,0.00,2048.67,516430.63,Non-important
633,18/02/2023,Movies,true,2813748390092,2550.32,0.00,513880.31,Important
634,19/02/2023,Grocery,false,2660886788935,0.00,2178.99,516059.30,Non-important
635,19/02/2023,Electronics,true,2609304729389,822.26,0.00,515237.04,Non-important
636,19/02/2023,Movies,true,2189321094092,471.39,0.00,514765.65,Non-important
637,19/02/2023,Home,false,2197436606406,0.00,873.59,515639.24,Non-Essential
638,19/02/2023,Home,true,2967309689514,828.98,0.00,514810.26,Essential
639,19/02/2023,Home,true,2445787672778,783.59,0.00,514026.67,Important
640,19/02/2023,Computers,false,2510852863767,0.00,1907.94,515934.61,Non-Essential
641,19/02/2023,Garden,false,2438601137797,0.00,1847.92,517782.53,Important
642,20/02/2023,Outdoors,false,2724688123242,0.00,2559.38,520341.91,Non-Essential
643,20/02/2023,Toys,true,2097513957868,2454.89,0.00,517887.02,Non-important
644,20/02/2023,Baby,true,2557552034677,1479.05,0.00,516407.97,Essential
645,20/02/2023,Outdoors,true,2375836322790,1988.15,0.00,514419.82,Essential
646,20/02/2023,Games,true,2569827154126,1461.47,0.00,512958.35,Essential
647,20/02/2023,Baby,true,2697093238973,458.96,0.00,512499.39,Essential
648,20/02/2023,Games,false,2466200861543,0.00,2757.54,515256.93,Non-important
649,20/02/2023,Beauty,false,2908277049206,0.00,2789.91,518046.84,Non-important
650,20/02/2023,Home,false,2884177189708,0.00,625.73,518672.57,Important
651,20/02/2023,Books,false,2524643963585,0.00,859.48,519532.05,Important
652,20/02/2023,Computers,true,2414552774683,762.74,0.00,518769.31,Essential
653,20/02/2023,Beauty,false,2126939166570,0.00,2571.42,521340.73,Essential
654,20/02/2023,Baby,false,2729371852845,0.00,1577.99,522918.72,Important
655,21/02/2023,Jewelry,true,2105170775153,2839.28,0.00,520079.44,Essential
656,21/02/2023,Garden,true,2957506688456,1156.57,0.00,518922.87,Non-Essential
657,21/02/2023,Health,true,2050336093191,2010.36,0.00,516912.51,Non-Essential
658,21/02/2023,Home,false,2601673084389,0.00,2718.06,519630.57,Essential
659,21/02/2023,Grocery,true,2792646068821,1209.40,0.00,518421.17,Non-Essential
660,21/02/2023,Music,false,2045493307712,0.00,477.14,518898.31,Important
661,21/02/2023,Industrial,false,2590608350820,0.00,2139.25,521037.56,Non-important
662,21/02/2023,Outdoors,false,2798883505016,0.00,2495.26,523532.82,Non-Essential
663,21/02/2023,Industrial,false,2154756324536,0.00,716.36,524249.18,Non-important
664,21/02/2023,Grocery,false,2138859559744,0.00,1284.56,525533.74,Non-important
665,21/02/2023,Health,false,2153402440964,0.00,538.26,526072.00,Non-important
666,21/02/2023,Electronics,false,2454594727167,0.00,1610.34,527682.34,Essential
667,21/02/2023,Computers,true,2229446277496,822.50,0.00,526859.84,Important
668,22/02/2023,Garden,true,2945873595753,1307.92,0.00,525551.92,Essential
669,22/02/2023,Automotive,false,2850487948061,0.00,169.08,525721.00,Non-Essential
670,22/02/2023,Automotive,false,2585866872024,0.00,1336.78,527057.78,Essential
671,22/02/2023,Electronics,true,2751967885395,2609.32,0.00,524448.46,Important
672,22/02/2023,Games,false,2054922841829,0.00,1618.12,526066.58,Non-important
673,22/02/2023,Grocery,true,2186664629861,2467.70,0.00,523598.88,Important
674,22/02/2023,Shoes,false,2495594746822,0.00,2748.02,526346.90,Important
675,22/02/2023,Tools,false,2791766037627,0.00,1620.79,527967.69,Non-important
676,22/02/2023,Toys,true,2635045886706,1690.65,0.00,526277.04,Non-Essential
677,22/02/2023,Shoes,false,2274943297741,0.00,2630.34,528907.38,Important
678,22/02/2023,Outdoors,true,2045834912060,1257.84,0.00,527649.54,Important
679,22/02/2023,Games,true,2991907504487,2220.16,0.00,525429.38,Important
680,23/02/2023,Grocery,false,2994432162215,0.00,371.86,525801.24,Non-important
681,23/02/2023,Electronics,true,2951736734171,1616.85,0.00,524184.39,Essential
682,23/02/2023,Home,true,2736496112570,2844.41,0.00,521339.98,Essential
683,23/02/2023,Electronics,true,2745493613880,740.85,0.00,520599.13,Important
684,23/02/2023,Shoes,true,2493425582372,775.19,0.00,519823.94,Essential
685,23/02/2023,Music,false,2615968667314,0.00,1256.01,521079.95,Essential
686,23/02/2023,Sports,true,2847355177959,2628.49,0.00,518451.46,Non-important
687,23/02/2023,Outdoors,false,2976332421443,0.00,495.93,518947.39,Non-Essential
688,23/02/2023,Toys,false,2426417120261,0.00,479.89,519427.28,Important
689,24/02/2023,Grocery,false,2624236547430,0.00,1632.57,521059.85,Essential
690,24/02/2023,Automotive,false,2815770859906,0.00,1519.55,522579.40,Non-Essential
691,24/02/2023,Beauty,false,2157586069763,0.00,1688.76,524268.16,Non-Essential
692,24/02/2023,Sports,false,2341538973478,0.00,1208.98,525477.14,Non-Essential
693,24/02/2023,Health,false,2198111934622,0.00,837.04,526314.18,Essential
694,24/02/2023,Electronics,false,2710121439823,0.00,925.01,527239.19,Important
695,24/02/2023,Games,false,2611292191387,0.00,682.18,527921.37,Essential
696,24/02/2023,Outdoors,true,2842690109202,2591.25,0.00,525330.12,Essential
697,24/02/2023,Movies,false,2461217763520,0.00,2239.98,527570.10,Essential
698,24/02/2023,Sports,false,2865710971898,0.00,2680.69,530250.79,Non-Essential
699,24/02/2023,Music,true,2071799996539,1799.85,0.00,528450.94,Essential
700,25/02/2023,Sports,true,2742537820558,1522.16,0.00,526928.78,Non-Essential
701,25/02/2023,Garden,true,2497890946122,1623.07,0.00,525305.71,Essential
702,25/02/2023,Music,false,2459386312825,0.00,2246.14,527551.85,Non-Essential
703,25/02/2023,Games,false,2356442192971,0.00,20.23,527572.08,Essential
704,25/02/2023,Games,true,2222197478103,353.31,0.00,527218.77,Essential
705,25/02/2023,Jewelry,true,2663303779019,530.07,0.00,526688.70,Non-Essential
706,25/02/2023,Toys,true,2020575092417,2882.17,0.00,523806.53,Non-important
707,25/02/2023,Health,false,2053355851304,0.00,2344.22,526150.75,Non-Essential
708,25/02/2023,Clothing,true,2920229578780,650.57,0.00,525500.18,Important
709,25/02/2023,Automotive,false,2839465875472,0.00,2444.01,527944.19,Non-Essential
710,25/02/2023,Electronics,true,2652091533873,1204.11,0.00,526740.08,Non-important
711,25/02/2023,Outdoors,false,2175361604452,0.00,2227.71,528967.79,Non-important
712,25/02/2023,Baby,true,2428011148939,1921.89,0.00,527045.90,Essential
713,25/02/2023,Industrial,false,2794784217045,0.00,1488.36,528534.26,Non-Essential
714,25/02/2023,Tools,false,2419408574357,0.00,2696.19,531230.45,Non-Essential
715,25/02/2023,Sports,true,2026148402063,1047.82,0.00,530182.63,Essential
716,25/02/2023,Games,false,2634202870494,0.00,103.91,530286.54,Non-Essential
717,26/02/2023,Baby,false,2212936301908,0.00,580.53,530867.07,Non-important
718,26/02/2023,Movies,false,2180632032943,0.00,326.74,531193.81,Essential
719,26/02/2023,Garden,true,2180705334024,1587.62,0.00,529606.19,Non-important
720,26/02/2023,Outdoors,false,2269055895959,0.00,475.83,530082.02,Non-important
721,26/02/2023,Shoes,true,2176384554755,421.67,0.00,529660.35,Essential
722,26/02/2023,Outdoors,true,2094945410566,43.74,0.00,529616.61,Non-Essential
723,26/02/2023,Kids,false,2876524929528,0.00,2972.54,532589.15,Non-Essential
724,26/02/2023,Automotive,true,2622205544933,659.09,0.00,531930.06,Non-Essential
725,26/02/2023,Outdoors,false,2104211875064,0.00,2416.13,534346.19,Essential
726,26/02/2023,Sports,false,2877093123964,0.00,2270.74,536616.93,Non-important
727,26/02/2023,Toys,true,2301423123973,297.17,0.00,536319.76,Non-Essential
728,26/02/2023,Health,true,2965462057909,2128.17,0.00,534191.59,Important
729,26/02/2023,Games,true,2401876163280,2037.89,0.00,532153.70,Non-important
730,27/02/2023,Home,true,2632534601691,2215.56,0.00,529938.14,Non-Essential
731,27/02/2023,Books,true,2029197954680,1707.73,0.00,528230.41,Essential
732,27/02/2023,Electronics,true,2993411526654,999.49,0.00,527230.92,Essential
733,27/02/2023,Health,true,2272305311888,1186.49,0.00,526044.43,Non-Essential
734,27/02/2023,Jewelry,true,2808028044378,1747.09,0.00,524297.34,Non-Essential
735,27/02/2023,Books,false,2974570694079,0.00,2535.96,526833.30,Important
736,27/02/2023,Automotive,false,2474501477831,0.00,532.03,527365.33,Non-important
737,27/02/2023,Kids,false,2373377985388,0.00,964.28,528329.61,Important
738,28/02/2023,Home,true,2700429367684,1218.24,0.00,527111.37,Essential
739,28/02/2023,Garden,true,2402620187299,27.50,0.00,527083.87,Non-important
740,28/02/2023,Movies,true,2742341360235,679.87,0.00,526404.00,Essential
741,28/02/2023,Outdoors,true,2987500229567,466.65,0.00,525937.35,Essential
742,28/02/2023,Sports,true,2496937711387,1079.97,0.00,524857.38,Important
743,28/02/2023,Clothing,false,2791409641433,0.00,593.48,525450.86,Important
744,28/02/2023,Outdoors,true,2812874242405,1837.98,0.00,523612.88,Non-Essential
745,28/02/2023,Movies,false,2398601817486,0.00,1236.58,524849.46,Non-Essential
746,28/02/2023,Tools,true,2424803194258,417.46,0.00,524432.00,Important
747,28/02/2023,Baby,false,2538175066783,0.00,1510.11,525942.11,Important
748,28/02/2023,Automotive,true,2784613113838,2540.75,0.00,523401.36,Essential
749,28/02/2023,Clothing,true,2350655377850,2709.64,0.00,520691.72,Non-Essential
750,28/02/2023,Beauty,true,2632236800388,2916.99,0.00,517774.73,Essential
751,28/02/2023,Movies,false,2770122963414,0.00,2826.92,520601.65,Non-important
752,28/02/2023,Garden,false,2023519872294,0.00,684.95,521286.60,Essential
753,01/03/2023,Sports,false,2946105965280,0.00,935.53,522222.13,Non-important
754,01/03/2023,Garden,true,2317571652916,2573.07,0.00,519649.06,Non-important
755,01/03/2023,Movies,true,2131904371485,2414.26,0.00,517234.80,Important
756,01/03/2023,Garden,true,2612198574858,1766.26,0.00,515468.54,Important
757,01/03/2023,Beauty,true,2114753486611,480.37,0.00,514988.17,Non-Essential
758,01/03/2023,Games,true,2239696901056,991.08,0.00,513997.09,Important
759,01/03/2023,Toys,false,2818955199419,0.00,888.25,514885.34,Essential
760,01/03/2023,Clothing,true,2402551323134,2700.21,0.00,512185.13,Non-Essential
761,01/03/2023,Beauty,false,2296398458875,0.00,434.63,512619.76,Important
762,01/03/2023,Automotive,true,2416285096779,1098.22,0.00,511521.54,Important
763,01/03/2023,Grocery,true,2532563579838,540.01,0.00,510981.53,Essential
764,01/03/2023,Automotive,false,2860448877710,0.00,2869.93,513851.46,Non-important
765,02/03/2023,Industrial,true,2646545018496,1820.78,0.00,512030.68,Non-Essential
766,02/03/2023,Toys,true,2068455607618,2588.88,0.00,509441.80,Non-important
767,02/03/2023,Computers,true,2759204214144,229.21,0.00,509212.59,Non-Essential
768,02/03/2023,Tools,true,2345819811453,1877.47,0.00,507335.12,Essential
769,02/03/2023,Grocery,false,2852252249662,0.00,1806.40,509141.52,Non-Essential
770,02/03/2023,Shoes,false,2213457119223,0.00,2320.55,511462.07,Non-Essential
771,02/03/2023,Clothing,true,2940515109967,338.37,0.00,511123.70,Non-important
772,02/03/2023,Tools,false,2802882416774,0.00,417.84,511541.54,Essential
773,02/03/2023,Books,false,2263490528996,0.00,1157.37,512698.91,Non-Essential
774,02/03/2023,Sports,true,2438481943569,2946.88,0.00,509752.03,Important
775,02/03/2023,Kids,false,2458748434423,0.00,1419.10,511171.13,Non-important
776,02/03/2023,Toys,true,2873363628421,950.93,0.00,510220.20,Important
777,02/03/2023,Movies,true,2083428854778,1791.42,0.00,508428.78,Essential
778,02/03/2023,Shoes,true,2780247611592,154.97,0.00,508273.81,Important
779,02/03/2023,Jewelry,false,2148766406502,0.00,1721.80,509995.61,Non-Essential
780,03/03/2023,Kids,true,2755516849793,2200.80,0.00,507794.81,Important
781,03/03/2023,Home,false,2138606404724,0.00,1838.46,509633.27,Non-Essential
782,03/03/2023,Music,true,2673350512119,2398.16,0.00,507235.11,Essential
783,03/03/2023,Tools,false,2591639748101,0.00,2432.88,509667.99,Non-Essential
784,03/03/2023,Electronics,false,2823516621664,0.00,2030.88,511698.87,Non-important
785,03/03/2023,Automotive,false,2690715473361,0.00,1702.56,513401.43,Important
786,03/03/2023,Health,true,2614883004815,2809.86,0.00,510591.57,Important
787,03/03/2023,Tools,true,2231028127047,406.03,0.00,510185.54,Essential
788,03/03/2023,Games,false,2293039724444,0.00,2890.84,513076.38,Important
789,03/03/2023,Tools,true,2011058159716,580.18,0.00,512496.20,Essential
790,03/03/2023,Toys,false,2772255639181,0.00,2337.94,514834.14,Important
791,03/03/2023,Health,true,2909206294051,512.87,0.00,514321.27,Important
792,04/03/2023,Toys,false,2902016476392,0.00,2605.46,516926.73,Non-important
793,04/03/2023,Outdoors,true,2668625885714,36.17,0.00,516890.56,Essential
794,04/03/2023,Tools,true,2509688832251,1885.03,0.00,515005.53,Non-Essential
795,04/03/2023,Jewelry,false,2168853492639,0.00,2672.65,517678.18,Non-Essential
796,04/03/2023,Kids,true,2250326734013,2685.96,0.00,514992.22,Non-important
797,04/03/2023,Beauty,true,2380928415171,1385.78,0.00,513606.44,Essential
798,04/03/2023,Industrial,false,2136893791719,0.00,245.31,513851.75,Essential
799,04/03/2023,Home,true,2991651068093,1113.97,0.00,512737.78,Non-important
800,04/03/2023,Garden,true,2044763197900,1783.28,0.00,510954.50,Non-Essential
801,04/03/2023,Clothing,true,2283221699102,2472.23,0.00,508482.27,Non-Essential
802,04/03/2023,Home,false,2206954040887,0.00,2865.82,511348.09,Non-important
803,04/03/2023,Toys,false,2575196062896,0.00,1169.06,512517.15,Non-Essential
804,04/03/2023,Computers,true,2079287899947,2766.42,0.00,509750.73,Non-Essential
805,04/03/2023,Sports,false,2189051063339,0.00,2095.27,511846.00,Non-important
806,05/03/2023,Clothing,false,2503493435477,0.00,1925.80,513771.80,Non-important
807,05/03/2023,Industrial,false,2146173591482,0.00,1043.44,514815.24,Non-Essential
808,05/03/2023,Toys,false,2863674576971,0.00,1984.36,516799.60,Non-Essential
809,05/03/2023,Games,false,2192555818653,0.00,1584.80,518384.40,Essential
810,05/03/2023,Electronics,true,2024310906360,417.88,0.00,517966.52,Essential
811,05/03/2023,Clothing,false,2532788513289,0.00,430.74,518397.26,Non-Essential
812,05/03/2023,Baby,true,2249442528090,142.46,0.00,518254.80,Essential
813,05/03/2023,Kids,true,2076343630084,61.93,0.00,518192.87,Non-Essential
814,05/03/2023,Games,true,2687059601989,911.05,0.00,517281.82,Important
815,05/03/2023,Kids,true,2109376470831,996.36,0.00,516285.46,Non-important
816,05/03/2023,Computers,false,2454208317059,0.00,1435.64,517721.10,Important
817,06/03/2023,Tools,false,2127846947270,0.00,216.94,517938.04,Important
818,06/03/2023,Kids,true,2934564877885,2241.41,0.00,515696.63,Non-Essential
819,06/03/2023,Tools,false,2803064500709,0.00,2933.36,518629.99,Essential
820,06/03/2023,Music,false,2556241450740,0.00,1546.04,520176.03,Essential
821,06/03/2023,Outdoors,true,2127629742942,831.05,0.00,519344.98,Essential
822,06/03/2023,Computers,true,2155273169738,757.66,0.00,518587.32,Essential
823,06/03/2023,Clothing,false,2610509374779,0.00,2198.79,520786.11,Important
824,06/03/2023,Outdoors,true,2248895384048,1874.93,0.00,518911.18,Non-important
825,06/03/2023,Jewelry,true,2281044698194,1612.18,0.00,517299.00,Essential
826,06/03/2023,Computers,true,2075932089065,1247.37,0.00,516051.63,Important
827,06/03/2023,Jewelry,true,2233162327174,535.41,0.00,515516.22,Essential
828,07/03/2023,Kids,true,2222116738634,1190.20,0.00,514326.02,Important
829,07/03/2023,Health,false,2405056928505,0.00,1252.18,515578.20,Non-Essential
830,07/03/2023,Industrial,true,2507628095551,69.79,0.00,515508.41,Essential
831,07/03/2023,Health,false,2966380520501,0.00,1172.15,516680.56,Non-important
832,07/03/2023,Books,false,2051051813872,0.00,2227.14,518907.70,Essential
833,07/03/2023,Jewelry,true,2305932260521,2791.11,0.00,516116.59,Essential
834,07/03/2023,Tools,true,2476924716749,1954.33,0.00,514162.26,Important
835,07/03/2023,Outdoors,false,2397225287246,0.00,1355.17,515517.43,Essential
836,08/03/2023,Baby,false,2279123846695,0.00,2555.16,518072.59,Non-Essential
837,08/03/2023,Automotive,true,2224930383768,1624.30,0.00,516448.29,Non-Essential
838,08/03/2023,Home,true,2548570819877,2408.51,0.00,514039.78,Important
839,08/03/2023,Health,false,2493088527749,0.00,1173.24,515213.02,Essential
840,08/03/2023,Automotive,false,2083123955175,0.00,1424.26,516637.28,Non-Essential
841,08/03/2023,Games,false,2973831078472,0.00,2404.11,519041.39,Important
842,08/03/2023,Kids,false,2545099548993,0.00,446.12,519487.51,Essential
843,08/03/2023,Computers,false,2500596388182,0.00,503.58,519991.09,Non-important
844,08/03/2023,Garden,true,2248615615706,403.09,0.00,519588.00,Important
845,08/03/2023,Shoes,false,2430730583476,0.00,2745.17,522333.17,Non-Essential
846,08/03/2023,Beauty,false,2075783490355,0.00,934.72,523267.89,Non-important
847,08/03/2023,Books,false,2254295163819,0.00,564.44,523832.33,Important
848,09/03/2023,Automotive,true,2042124049788,1547.89,0.00,522284.44,Important
849,09/03/2023,Sports,false,2979588380926,0.00,2737.79,525022.23,Important
850,09/03/2023,Grocery,true,2047973637579,502.21,0.00,524520.02,Non-important
851,09/03/2023,Tools,true,2680611509277,774.97,0.00,523745.05,Important
852,09/03/2023,Outdoors,true,2801953251696,1372.53,0.00,522372.52,Non-Essential
853,09/03/2023,Jewelry,true,2781107723223,442.41,0.00,521930.11,Non-important
854,09/03/2023,Garden,false,2757376677230,0.00,2035.80,523965.91,Essential
855,09/03/2023,Games,false,2034124531325,0.00,113.01,524078.92,Essential
856,09/03/2023,Electronics,false,2835643576190,0.00,1705.63,525784.55,Essential
857,10/03/2023,Health,true,2256455177549,1402.19,0.00,524382.36,Non-important
858,10/03/2023,Clothing,true,2426554913149,2263.47,0.00,522118.89,Non-Essential
859,10/03/2023,Home,false,2650894471492,0.00,2692.96,524811.85,Non-Essential
860,10/03/2023,Computers,true,2547476555884,1496.69,0.00,523315.16,Non-important
861,10/03/2023,Clothing,false,2876561809050,0.00,1856.40,525171.56,Essential
862,10/03/2023,Movies,false,2891969812595,0.00,2516.24,527687.80,Important
863,10/03/2023,Shoes,true,2137006008042,1308.41,0.00,526379.39,Non-Essential
864,11/03/2023,Books,false,2674471361044,0.00,584.33,526963.72,Important
865,11/03/2023,Kids,true,2482557553895,1344.58,0.00,525619.14,Non-important
866,11/03/2023,Outdoors,false,2210867940077,0.00,2127.48,527746.62,Important
867,11/03/2023,Toys,true,2128489927557,1730.66,0.00,526015.96,Non-important
868,11/03/2023,Computers,true,2989849377059,2697.13,0.00,523318.83,Non-important
869,11/03/2023,Baby,false,2039369420531,0.00,83.86,523402.69,Non-important
870,11/03/2023,Games,true,2179691929834,168.38,0.00,523234.31,Essential
871,11/03/2023,Computers,false,2512419694274,0.00,1414.47,524648.78,Essential
872,11/03/2023,Baby,true,2324265576548,153.23,0.00,524495.55,Non-Essential
873,11/03/2023,Electronics,false,2280335885122,0.00,794.27,525289.82,Important
874,12/03/2023,Computers,true,2592626355972,2852.56,0.00,522437.26,Non-important
875,12/03/2023,Outdoors,false,2159092392374,0.00,2157.22,524594.48,Non-Essential
876,12/03/2023,Music,false,2979052263224,0.00,1333.57,525928.05,Non-Essential
877,12/03/2023,Jewelry,true,2474641490789,1677.81,0.00,524250.24,Non-Essential
878,12/03/2023,Outdoors,false,2451158718160,0.00,1463.54,525713.78,Non-important
879,12/03/2023,Shoes,false,2820086804353,0.00,2404.10,528117.88,Non-important
880,12/03/2023,Music,true,2959524881117,485.23,0.00,527632.65,Non-Essential
881,12/03/2023,Shoes,true,2139104553287,763.23,0.00,526869.42,Non-Essential
882,12/03/2023,Garden,false,2348284810308,0.00,1894.09,528763.51,Non-important
883,12/03/2023,Kids,true,2297464019355,2137.14,0.00,526626.37,Essential
884,12/03/2023,Kids,true,2972175152039,2190.05,0.00,524436.32,Non-Essential
885,12/03/2023,Beauty,true,2622652854041,1806.63,0.00,522629.69,Non-Essential
886,12/03/2023,Kids,true,2646298634519,90.33,0.00,522539.36,Non-important
887,12/03/2023,Industrial,false,2607751496482,0.00,513.47,523052.83,Non-important
888,12/03/2023,Tools,true,2782059405294,102.44,0.00,522950.39,Essential
889,12/03/2023,Shoes,true,2362568404640,2997.90,0.00,519952.49,Important
890,12/03/2023,Sports,true,2206175219093,2744.61,0.00,517207.88,Non-Essential
891,12/03/2023,Computers,false,2916281099891,0.00,1931.54,519139.42,Non-important
892,12/03/2023,Music,true,2773630453020,2493.65,0.00,516645.77,Essential
893,12/03/2023,Industrial,false,2239299687041,0.00,1396.32,518042.09,Important
894,12/03/2023,Games,true,2043511466058,1089.36,0.00,516952.73,Non-important
895,13/03/2023,Kids,false,2101918159611,0.00,2745.82,519698.55,Non-Essential
896,13/03/2023,Toys,false,2347005750626,0.00,2277.41,521975.96,Important
897,13/03/2023,Industrial,true,2452448033285,140.06,0.00,521835.90,Important
898,13/03/2023,Shoes,true,2524537234039,2580.01,0.00,519255.89,Essential
899,13/03/2023,Movies,true,2795634618597,964.65,0.00,518291.24,Important
900,13/03/2023,Games,false,2455913877735,0.00,692.82,518984.06,Non-Essential
901,13/03/2023,Outdoors,true,2805389710244,30.83,0.00,518953.23,Non-Essential
902,13/03/2023,Garden,true,2179911284192,447.94,0.00,518505.29,Essential
903,13/03/2023,Books,true,2374956199244,1193.85,0.00,517311.44,Non-Essential
904,14/03/2023,Outdoors,false,2621424945312,0.00,16.40,517327.84,Important
905,14/03/2023,Jewelry,false,2306074582562,0.00,1540.07,518867.91,Non-Essential
906,14/03/2023,Movies,true,2090104266876,2141.51,0.00,516726.40,Non-Essential
907,14/03/2023,Music,true,2314378693501,1048.32,0.00,515678.08,Essential
908,14/03/2023,Health,false,2662209863151,0.00,2425.54,518103.62,Non-Essential
909,14/03/2023,Toys,true,2440239379976,2592.69,0.00,515510.93,Important
910,14/03/2023,Sports,false,2033535774211,0.00,2030.64,517541.57,Non-important
911,14/03/2023,Industrial,true,2805038260685,662.64,0.00,516878.93,Non-Essential
912,14/03/2023,Movies,false,2582181921590,0.00,99.35,516978.28,Essential
913,15/03/2023,Electronics,true,2758415473708,886.06,0.00,516092.22,Essential
914,15/03/2023,Jewelry,true,2448571982873,1419.12,0.00,514673.10,Non-important
915,15/03/2023,Home,true,2876844807045,2180.43,0.00,512492.67,Important
916,15/03/2023,Industrial,true,2755464308919,537.99,0.00,511954.68,Non-Essential
917,15/03/2023,Music,true,2554260985016,1138.84,0.00,510815.84,Non-important
918,15/03/2023,Toys,true,2273649240008,1019.74,0.00,509796.10,Non-Essential
919,15/03/2023,Health,false,2852481069383,0.00,1996.59,511792.69,Non-important
920,15/03/2023,Sports,true,2573317214417,110.06,0.00,511682.63,Non-important
921,15/03/2023,Baby,false,2058594101298,0.00,2693.37,514376.00,Non-Essential
922,15/03/2023,Health,false,2500921440034,0.00,2938.59,517314.59,Essential
923,16/03/2023,Movies,false,2139791049602,0.00,2386.50,519701.09,Important
924,16/03/2023,Outdoors,false,2579663254185,0.00,439.69,520140.78,Non-important
925,16/03/2023,Books,false,2362637418611,0.00,1146.76,521287.54,Important
926,17/03/2023,Shoes,false,2251858364140,0.00,964.97,522252.51,Non-important
927,17/03/2023,Games,false,2648294748723,0.00,973.11,523225.62,Important
928,17/03/2023,Movies,false,2605553590243,0.00,2281.68,525507.30,Non-important
929,17/03/2023,Toys,true,2202034677315,122.13,0.00,525385.17,Non-important
930,17/03/2023,Grocery,true,2936113858714,2019.01,0.00,523366.16,Non-Essential
931,17/03/2023,Industrial,false,2669993350717,0.00,1567.22,524933.38,Essential
932,17/03/2023,Grocery,true,2871301188840,2678.31,0.00,522255.07,Non-important
933,17/03/2023,Toys,true,2323558649838,2994.14,0.00,519260.93,Non-Essential
934,17/03/2023,Grocery,false,2720090177509,0.00,137.40,519398.33,Essential
935,17/03/2023,Garden,true,2591561843319,1435.45,0.00,517962.88,Essential
936,17/03/2023,Health,false,2489886367496,0.00,2404.97,520367.85,Non-Essential
937,17/03/2023,Books,true,2773956123346,1433.24,0.00,518934.61,Non-important
938,17/03/2023,Grocery,false,2915266756123,0.00,2306.37,521240.98,Non-Essential
939,17/03/2023,Beauty,false,2193751647947,0.00,767.02,522008.00,Non-important
940,17/03/2023,Health,true,2763076604443,1094.72,0.00,520913.28,Important
941,17/03/2023,Baby,false,2907710727200,0.00,1420.21,522333.49,Essential
942,18/03/2023,Movies,true,2371113880479,320.19,0.00,522013.30,Important
943,18/03/2023,Baby,false,2175607008818,0.00,162.81,522176.11,Important
944,18/03/2023,Sports,false,2166220544982,0.00,1588.72,523764.83,Essential
945,18/03/2023,Outdoors,true,2602150663049,1883.63,0.00,521881.20,Non-important
946,18/03/2023,Games,false,2049915328285,0.00,1740.49,523621.69,Essential
947,18/03/2023,Jewelry,true,2742886526769,202.44,0.00,523419.25,Non-Essential
948,18/03/2023,Outdoors,true,2827298335378,2009.31,0.00,521409.94,Non-important
949,18/03/2023,Games,false,2793713990625,0.00,2373.03,523782.97,Important
950,18/03/2023,Garden,true,2981819497420,733.41,0.00,523049.56,Essential
951,18/03/2023,Automotive,true,2530192144508,998.98,0.00,522050.58,Non-important
952,18/03/2023,Beauty,false,2839160740686,0.00,1380.72,523431.30,Essential
953,19/03/2023,Baby,false,2401867533051,0.00,2779.41,526210.71,Essential
954,19/03/2023,Electronics,true,2966016710263,2197.35,0.00,524013.36,Essential
955,19/03/2023,Kids,true,2620759335389,862.26,0.00,523151.10,Important
956,19/03/2023,Baby,true,2063745727446,182.15,0.00,522968.95,Non-Essential
957,19/03/2023,Jewelry,true,2618008048584,2235.00,0.00,520733.95,Non-Essential
958,19/03/2023,Music,true,2207343027093,2802.55,0.00,517931.40,Important
959,19/03/2023,Outdoors,false,2044071019113,0.00,1.01,517932.41,Essential
960,19/03/2023,Shoes,true,2843309806254,2270.24,0.00,515662.17,Non-Essential
961,19/03/2023,Shoes,false,2749684932067,0.00,1370.36,517032.53,Non-Essential
962,19/03/2023,Electronics,true,2363186191274,2784.98,0.00,514247.55,Essential
963,19/03/2023,Clothing,false,2346044091110,0.00,152.13,514399.68,Non-important
964,19/03/2023,Tools,false,2917349419587,0.00,1198.18,515597.86,Important
965,19/03/2023,Games,true,2467403735886,1629.22,0.00,513968.64,Non-important
966,19/03/2023,Grocery,true,2211064929679,2952.85,0.00,511015.79,Non-important
967,19/03/2023,Sports,true,2395101619433,2624.91,0.00,508390.88,Important
968,19/03/2023,Automotive,false,2396217386940,0.00,37.79,508428.67,Non-important
969,20/03/2023,Jewelry,true,2264145780505,2778.02,0.00,505650.65,Essential
970,20/03/2023,Kids,true,2792490345780,2825.83,0.00,502824.82,Essential
971,20/03/2023,Electronics,true,2523355562875,176.93,0.00,502647.89,Essential
972,20/03/2023,Music,false,2230352030035,0.00,2307.03,504954.92,Non-important
973,20/03/2023,Baby,false,2312848992317,0.00,336.90,505291.82,Non-Essential
974,20/03/2023,Industrial,false,2768290704598,0.00,2244.37,507536.19,Non-important
975,20/03/2023,Tools,false,2289329351204,0.00,404.63,507940.82,Important
976,20/03/2023,Sports,false,2281292944304,0.00,2532.98,510473.80,Important
977,20/03/2023,Grocery,true,2948657712907,1786.45,0.00,508687.35,Non-important
978,20/03/2023,Books,true,2114767341144,1676.44,0.00,507010.91,Non-Essential
979,20/03/2023,Garden,false,2486498642299,0.00,652.31,507663.22,Non-important
980,21/03/2023,Toys,true,2006091361473,943.60,0.00,506719.62,Non-Essential
981,21/03/2023,Automotive,false,2310502463566,0.00,725.04,507444.66,Essential
982,21/03/2023,Health,false,2933266384588,0.00,1182.17,508626.83,Non-Essential
983,21/03/2023,Industrial,true,2194453601005,2202.74,0.00,506424.09,Non-important
984,21/03/2023,Shoes,true,2166934787845,315.06,0.00,506109.03,Non-important
985,21/03/2023,Kids,true,2037766245160,1718.09,0.00,504390.94,Important
986,21/03/2023,Toys,true,2769780725992,1727.33,0.00,502663.61,Non-important
987,21/03/2023,Electronics,true,2773501997882,415.26,0.00,502248.35,Essential
988,21/03/2023,Industrial,true,2434553409731,2882.73,0.00,499365.62,Non-Essential
989,22/03/2023,Baby,false,2018462415284,0.00,1620.08,500985.70,Essential
990,22/03/2023,Toys,false,2245575841640,0.00,894.58,501880.28,Important
991,22/03/2023,Garden,false,2626774078925,0.00,1605.56,503485.84,Important
992,22/03/2023,Baby,false,2544845687169,0.00,1027.49,504513.33,Non-Essential
993,22/03/2023,Computers,false,2056533111205,0.00,2972.94,507486.27,Non-Essential
994,22/03/2023,Computers,true,2340881957624,99.71,0.00,507386.56,Non-important
995,22/03/2023,Kids,false,2792823161702,0.00,1953.46,509340.02,Non-important
996,22/03/2023,Garden,true,2583339860821,530.74,0.00,508809.28,Non-Essential
997,22/03/2023,Books,true,2960101898434,628.21,0.00,508181.07,Non-Essential
998,22/03/2023,Books,true,2944085170994,2360.83,0.00,505820.24,Non-important
999,22/03/2023,Electronics,false,2008134651678,0.00,2663.06,508483.30,Essential
1000,22/03/2023,Outdoors,true,2665354316796,861.79,0.00,507621.51,Non-Essential
