row,Txn Date,Description,Transfer To/From,Ref No./Cheque No.,Debit,Credit,Balance,Class
1,23/12/2022,Jewelry,true,3172376751536,15.03,0.00,691447.16,Essential
2,23/12/2022,Clothing,false,3047405612279,0.00,2173.29,693620.45,Essential
3,23/12/2022,Kids,true,3955134731593,2460.27,0.00,691160.18,Non-Essential
4,23/12/2022,Baby,true,3890881898497,891.91,0.00,690268.27,Non-important
5,23/12/2022,Home,true,3296868927279,1631.99,0.00,688636.28,Essential
6,23/12/2022,Toys,false,3056441772155,0.00,689.40,689325.68,Essential
7,23/12/2022,Shoes,true,3699479745208,4989.67,0.00,684336.01,Non-important
8,23/12/2022,Music,true,3523751436703,4198.53,0.00,680137.48,Essential
9,23/12/2022,Shoes,false,3746575115785,0.00,643.93,680781.41,Non-Essential
10,24/12/2022,Outdoors,true,3432664137502,3520.52,0.00,677260.89,Non-important
11,24/12/2022,Baby,true,3305347649067,3511.07,0.00,673749.82,Non-important
12,24/12/2022,Books,false,3202285334852,0.00,1241.94,674991.76,Important
13,24/12/2022,Games,false,3784996571812,0.00,488.00,675479.76,Non-Essential
14,24/12/2022,Beauty,true,3613455213765,1275.39,0.00,674204.37,Non-important
15,25/12/2022,Music,true,3703220364540,1538.40,0.00,672665.97,Essential
16,25/12/2022,Tools,true,3443367651780,2774.93,0.00,669891.04,Important
17,25/12/2022,Kids,false,3591045528851,0.00,2669.83,672560.87,Non-Essential
18,25/12/2022,Automotive,false,3778261626048,0.00,521.14,673082.01,Essential
19,25/12/2022,Tools,false,3442747352790,0.00,2641.67,675723.68,Important
20,25/12/2022,Health,false,3656371262961,0.00,210.67,675934.35,Essential
21,25/12/2022,Shoes,true,3948728892432,3203.20,0.00,672731.15,Non-Essential
22,25/12/2022,Computers,true,3231394930144,4658.91,0.00,668072.24,Non-important
23,25/12/2022,Music,false,3718594820389,0.00,2174.41,670246.65,Non-Essential
24,25/12/2022,Tools,false,3695980821675,0.00,1757.30,672003.95,Non-important
25,25/12/2022,Outdoors,true,3643505122042,2291.06,0.00,669712.89,Essential
26,26/12/2022,Beauty,false,3054120243934,0.00,810.50,670523.39,Non-Essential
27,26/12/2022,Clothing,true,3021911507517,21.66,0.00,670501.73,Essential
28,26/12/2022,Clothing,true,3526559521076,1747.41,0.00,668754.32,Non-important
29,26/12/2022,Music,false,3042229506209,0.00,1441.80,670196.12,Important
30,26/12/2022,Beauty,false,3145881822372,0.00,2708.31,672904.43,Non-Essential
31,26/12/2022,Jewelry,false,3090703241886,0.00,1598.00,674502.43,Non-important
32,26/12/2022,Clothing,false,3539894292892,0.00,1387.38,675889.81,Non-important
33,26/12/2022,Shoes,false,3040460257420,0.00,1913.70,677803.51,Essential
34,26/12/2022,Beauty,false,3206384519878,0.00,163.40,677966.91,Non-important
35,26/12/2022,Toys,true,3166603412596,2664.12,0.00,675302.79,Important
36,26/12/2022,Jewelry,true,3460086382586,1591.17,0.00,673711.62,Essential
37,26/12/2022,Movies,true,3600105840533,595.13,0.00,673116.49,Non-Essential
38,26/12/2022,Tools,false,3165161379646,0.00,344.77,673461.26,Essential
39,26/12/2022,Industrial,false,3172499171529,0.00,89.54,673550.80,Essential
40,26/12/2022,Garden,false,3616974696680,0.00,2193.78,675744.58,Non-important
41,26/12/2022,Jewelry,true,3424046824806,3675.07,0.00,672069.51,Non-Essential
42,27/12/2022,Books,false,3836933938749,0.00,689.50,672759.01,Important
43,27/12/2022,Outdoors,true,3887087039257,3822.30,0.00,668936.71,Important
44,27/12/2022,Kids,false,3455167212741,0.00,979.47,669916.18,Essential
45,27/12/2022,Computers,false,3607449326978,0.00,2049.50,671965.68,Non-Essential
46,27/12/2022,Baby,false,3295135229796,0.00,496.38,672462.06,Non-Essential
47,27/12/2022,Books,true,3029839882174,2930.53,0.00,669531.53,Important
48,27/12/2022,Kids,true,3080735963132,616.72,0.00,668914.81,Essential
49,27/12/2022,Automotive,true,3485424496036,2938.71,0.00,665976.10,Essential
50,27/12/2022,Games,false,3366641986085,0.00,758.37,666734.47,Essential
51,28/12/2022,Health,false,3351895786633,0.00,434.96,667169.43,Essential
52,28/12/2022,Shoes,true,3712996801805,225.40,0.00,666944.03,Non-important
53,28/12/2022,Tools,false,3464553491425,0.00,1828.69,668772.72,Important
54,28/12/2022,Books,false,3386119569582,0.00,894.08,669666.80,Non-Essential
55,28/12/2022,Electronics,false,3279379477642,0.00,2553.41,672220.21,Non-important
56,28/12/2022,Music,true,3033525883094,2811.91,0.00,669408.30,Essential
57,28/12/2022,Music,true,3766592880793,1225.64,0.00,668182.66,Non-important
58,28/12/2022,Sports,true,3271671930630,4951.88,0.00,663230.78,Non-important
59,28/12/2022,Movies,false,3930401454533,0.00,1158.56,664389.34,Essential
60,28/12/2022,Kids,false,3364021622929,0.00,714.23,665103.57,Essential
61,29/12/2022,Shoes,true,3245521795987,3231.97,0.00,661871.60,Important
62,29/12/2022,Movies,true,3929605567078,4278.14,0.00,657593.46,Important
63,29/12/2022,Kids,true,3403505783975,3154.42,0.00,654439.04,Non-important
64,29/12/2022,Automotive,false,3992847501479,0.00,479.90,654918.94,Non-important
65,29/12/2022,Shoes,false,3464748689235,0.00,1833.91,656752.85,Important
66,29/12/2022,Clothing,false,3415665250836,0.00,2508.77,659261.62,Essential
67,29/12/2022,Books,false,3317023515556,0.00,566.95,659828.57,Non-Essential
68,29/12/2022,Books,true,3419113112197,1387.54,0.00,658441.03,Important
69,29/12/2022,Tools,false,3076482846831,0.00,2952.08,661393.11,Essential
70,29/12/2022,Movies,false,3183307703765,0.00,2136.76,663529.87,Non-Essential
71,30/12/2022,Movies,true,3308004020520,1368.61,0.00,662161.26,Essential
72,30/12/2022,Movies,true,3463032196528,473.11,0.00,661688.15,Non-important
73,30/12/2022,Outdoors,false,3356553805024,0.00,2953.94,664642.09,Non-important
74,30/12/2022,Kids,true,3441042294957,3691.64,0.00,660950.45,Essential
75,31/12/2022,Kids,true,3279242799538,4511.90,0.00,656438.55,Non-Essential
76,31/12/2022,Garden,true,3713750921834,1494.48,0.00,654944.07,Non-Essential
77,31/12/2022,Books,false,3417406859122,0.00,1910.69,656854.76,Important
78,31/12/2022,Computers,true,3136524322955,4940.44,0.00,651914.32,Non-important
79,31/12/2022,Outdoors,false,3463158425413,0.00,2825.03,654739.35,Non-important
80,31/12/2022,Industrial,true,3802469166134,3124.85,0.00,651614.50,Important
81,31/12/2022,Outdoors,false,3205632138679,0.00,2554.47,654168.97,Important
82,31/12/2022,Tools,true,3962795980710,4260.57,0.00,649908.40,Essential
83,31/12/2022,Tools,true,3519141159623,977.91,0.00,648930.49,Non-Essential
84,31/12/2022,Shoes,true,3441351385590,84.39,0.00,648846.10,Essential
85,31/12/2022,Garden,true,3786548756261,3104.49,0.00,645741.61,Non-important
86,31/12/2022,Tools,false,3365499869646,0.00,1557.82,647299.43,Non-important
87,01/01/2023,Jewelry,true,3075727332651,2379.44,0.00,644919.99,Important
88,01/01/2023,Computers,true,3461594609906,725.29,0.00,644194.70,Non-Essential
89,01/01/2023,Tools,true,3422864900017,4844.75,0.00,639349.95,Non-important
90,01/01/2023,Clothing,true,3808567667500,472.15,0.00,638877.80,Essential
91,01/01/2023,Home,false,3084687121284,0.00,2495.25,641373.05,Essential
92,01/01/2023,Garden,false,3998323590449,0.00,1244.35,642617.40,Essential
93,01/01/2023,Sports,false,3230378432479,0.00,2379.24,644996.64,Non-Essential
94,01/01/2023,Baby,true,3729203416563,4507.50,0.00,640489.14,Essential
95,01/01/2023,Outdoors,false,3427373288481,0.00,2403.58,642892.72,Non-Essential
96,01/01/2023,Home,true,3379445361765,4577.42,0.00,638315.30,Essential
97,01/01/2023,Beauty,true,3175489454513,1942.85,0.00,636372.45,Important
98,01/01/2023,Garden,false,3982707547052,0.00,742.79,637115.24,Non-Essential
99,01/01/2023,Kids,true,3730439686161,4454.21,0.00,632661.03,Important
100,02/01/2023,Sports,false,3707706255177,0.00,1499.29,634160.32,Important
101,02/01/2023,Kids,true,3451166640191,1505.10,0.00,632655.22,Important
102,02/01/2023,Computers,true,3613190914451,4887.58,0.00,627767.64,Important
103,02/01/2023,Sports,true,3329298148073,2494.58,0.00,625273.06,Non-important
104,02/01/2023,Grocery,true,3310752240223,3447.19,0.00,621825.87,Important
105,02/01/2023,Jewelry,false,3736580712415,0.00,85.44,621911.31,Non-Essential
106,02/01/2023,Grocery,true,3421905246816,638.33,0.00,621272.98,Essential
107,02/01/2023,Beauty,true,3817499765675,1389.42,0.00,619883.56,Essential
108,02/01/2023,Home,false,3875860608506,0.00,1078.59,620962.15,Non-Essential
109,02/01/2023,Computers,false,3471663980156,0.00,1960.50,622922.65,Non-Essential
110,02/01/2023,Shoes,true,3681969505188,1361.41,0.00,621561.24,Important
111,02/01/2023,Kids,true,3198647175042,3163.71,0.00,618397.53,Non-Essential
112,02/01/2023,Toys,false,3477726276752,0.00,728.62,619126.15,Non-important
113,02/01/2023,Books,false,3136509159097,0.00,547.89,619674.04,Important
114,02/01/2023,Electronics,false,3124414434444,0.00,2092.16,621766.20,Important
115,02/01/2023,Clothing,false,3312078268917,0.00,1704.44,623470.64,Non-Essential
116,02/01/2023,Health,true,3946320509250,3534.24,0.00,619936.40,Non-Essential
117,03/01/2023,Health,true,3769523971250,1685.21,0.00,618251.19,Non-Essential
118,03/01/2023,Clothing,false,3438698167659,0.00,1910.83,620162.02,Non-Essential
119,03/01/2023,Health,false,3028664484946,0.00,2011.25,622173.27,Essential
120,03/01/2023,Automotive,false,3897124241928,0.00,2136.61,624309.88,Essential
121,03/01/2023,Industrial,true,3341113213643,2851.89,0.00,621457.99,Non-important
122,03/01/2023,Automotive,false,3082276366994,0.00,2915.82,624373.81,Important
123,03/01/2023,Electronics,true,3730503353978,1966.73,0.00,622407.08,Essential
124,03/01/2023,Movies,true,3490126778297,1637.84,0.00,620769.24,Essential
125,03/01/2023,Kids,false,3246459893072,0.00,1110.20,621879.44,Essential
126,03/01/2023,Industrial,false,3560610849637,0.00,370.08,622249.52,Non-Essential
127,03/01/2023,Health,false,3933012676958,0.00,17.63,622267.15,Non-Essential
128,03/01/2023,Grocery,true,3188926068466,736.38,0.00,621530.77,Essential
129,03/01/2023,Automotive,false,3773750352495,0.00,1441.44,622972.21,Important
130,03/01/2023,Health,true,3527330235667,499.26,0.00,622472.95,Non-important
131,03/01/2023,Computers,false,3903562342316,0.00,1513.90,623986.85,Non-Essential
132,04/01/2023,Movies,false,3659390182692,0.00,740.76,624727.61,Non-important
133,04/01/2023,Sports,false,3050924833617,0.00,1900.81,626628.42,Important
134,04/01/2023,Home,true,3181453130613,273.97,0.00,626354.45,Non-important
135,04/01/2023,Baby,false,3539525446042,0.00,2576.02,628930.47,Essential
136,04/01/2023,Automotive,true,3854269201320,797.37,0.00,628133.10,Essential
137,04/01/2023,Home,true,3014777560869,2811.66,0.00,625321.44,Non-important
138,04/01/2023,Baby,false,3986113413251,0.00,603.95,625925.39,Important
139,04/01/2023,Jewelry,true,3180746345551,12.63,0.00,625912.76,Non-important
140,04/01/2023,Books,true,3611938096801,3888.68,0.00,622024.08,Important
141,04/01/2023,Kids,false,3209142625122,0.00,2294.71,624318.79,Important
142,04/01/2023,Garden,true,3529557079237,584.81,0.00,623733.98,Essential
143,04/01/2023,Jewelry,true,3515812468710,748.96,0.00,622985.02,Non-Essential
144,05/01/2023,Garden,true,3674577703115,4114.25,0.00,618870.77,Non-important
145,05/01/2023,Health,false,3195366570375,0.00,2919.76,621790.53,Non-important
146,05/01/2023,Garden,true,3961833640304,1302.39,0.00,620488.14,Essential
147,05/01/2023,Games,false,3839203689172,0.00,1567.07,622055.21,Non-important
148,05/01/2023,Clothing,true,3892757942050,3031.43,0.00,619023.78,Essential
149,05/01/2023,Garden,true,3381444556025,737.51,0.00,618286.27,Non-important
150,05/01/2023,Movies,true,3915028739209,36.61,0.00,618249.66,Non-important
151,05/01/2023,Games,false,3918482080586,0.00,497.61,618747.27,Important
152,05/01/2023,Outdoors,false,3388201618823,0.00,2952.82,621700.09,Important
153,05/01/2023,Movies,false,3489432145065,0.00,2566.72,624266.81,Non-important
154,05/01/2023,Movies,false,3413567941372,0.00,2047.60,626314.41,Non-Essential
155,06/01/2023,Shoes,true,3858416126098,897.88,0.00,625416.53,Non-important
156,06/01/2023,Garden,false,3696313613503,0.00,1180.82,626597.35,Essential
157,06/01/2023,Jewelry,false,3767843682168,0.00,2542.98,629140.33,Important
158,06/01/2023,Baby,false,3792269827186,0.00,2568.63,631708.96,Non-Essential
159,06/01/2023,Beauty,true,3840147943283,1117.89,0.00,630591.07,Essential
160,06/01/2023,Sports,false,3446525328291,0.00,113.70,630704.77,Essential
161,06/01/2023,Shoes,false,3138299710408,0.00,1242.37,631947.14,Important
162,06/01/2023,Automotive,false,3305079013680,0.00,723.30,632670.44,Non-important
163,06/01/2023,Shoes,true,3377156590511,218.22,0.00,632452.22,Non-Essential
164,06/01/2023,Toys,false,3684587512505,0.00,2600.98,635053.20,Important
165,06/01/2023,Clothing,true,3088848913340,3705.37,0.00,631347.83,Non-Essential
166,06/01/2023,Outdoors,true,3157749488254,3425.10,0.00,627922.73,Non-Essential
167,07/01/2023,Kids,true,3793258943322,1362.01,0.00,626560.72,Essential
168,07/01/2023,Health,true,3479120500227,468.16,0.00,626092.56,Important
169,07/01/2023,Grocery,false,3969865717607,0.00,509.38,626601.94,Essential
170,07/01/2023,Music,true,3314922255473,1728.99,0.00,624872.95,Important
171,07/01/2023,Toys,false,3238357508773,0.00,2202.50,627075.45,Non-important
172,07/01/2023,Baby,false,3425301550667,0.00,2617.80,629693.25,Essential
173,07/01/2023,Computers,false,3900629373707,0.00,2697.69,632390.94,Important
174,07/01/2023,Automotive,false,3076775325707,0.00,1981.49,634372.43,Non-important
175,07/01/2023,Jewelry,true,3501929769452,4816.08,0.00,629556.35,Important
176,07/01/2023,Health,true,3873802440058,3883.44,0.00,625672.91,Non-important
177,07/01/2023,Kids,true,3256567078891,2079.22,0.00,623593.69,Non-Essential
178,08/01/2023,Automotive,true,3099124729851,1844.01,0.00,621749.68,Non-important
179,08/01/2023,Movies,false,3162400559189,0.00,2517.94,624267.62,Non-important
180,08/01/2023,Tools,false,3646733121659,0.00,1370.75,625638.37,Non-Essential
181,08/01/2023,Jewelry,false,3756501128852,0.00,192.90,625831.27,Non-important
182,08/01/2023,Movies,false,3466941774482,0.00,1055.24,626886.51,Non-important
183,08/01/2023,Shoes,false,3148524647601,0.00,683.29,627569.80,Essential
184,08/01/2023,Clothing,false,3009723975172,0.00,2409.22,629979.02,Important
185,08/01/2023,Clothing,true,3493792511420,2367.49,0.00,627611.53,Non-important
186,08/01/2023,Baby,true,3810380924462,1315.14,0.00,626296.39,Essential
187,08/01/2023,Toys,true,3161665293455,4229.31,0.00,622067.08,Essential
188,08/01/2023,Kids,false,3140326306226,0.00,2775.39,624842.47,Non-Essential
189,09/01/2023,Jewelry,true,3813747683243,4713.59,0.00,620128.88,Important
190,09/01/2023,Grocery,false,3087350354882,0.00,2125.44,622254.32,Non-Essential
191,09/01/2023,Industrial,true,3226263661979,2006.44,0.00,620247.88,Essential
192,09/01/2023,Tools,true,3305221402985,719.75,0.00,619528.13,Non-Essential
193,09/01/2023,Tools,true,3209015204769,1491.12,0.00,618037.01,Non-important
194,09/01/2023,Shoes,true,3030854923242,4049.67,0.00,613987.34,Non-important
195,09/01/2023,Shoes,true,3123048230898,1517.35,0.00,612469.99,Non-Essential
196,10/01/2023,Sports,false,3012061489059,0.00,2631.96,615101.95,Non-Essential
197,10/01/2023,Garden,false,3793708929560,0.00,320.05,615422.00,Essential
198,10/01/2023,Baby,true,3291452969492,566.45,0.00,614855.55,Non-important
199,10/01/2023,Jewelry,true,3532214251150,719.08,0.00,614136.47,Essential
200,10/01/2023,Outdoors,false,3307147331551,0.00,1110.66,615247.13,Non-important
201,10/01/2023,Shoes,true,3014210318301,1414.77,0.00,613832.36,Important
202,10/01/2023,Baby,true,3570290627583,2005.83,0.00,611826.53,Important
203,10/01/2023,Automotive,true,3229496450964,3283.40,0.00,608543.13,Important
204,10/01/2023,Toys,true,3697594935093,3241.90,0.00,605301.23,Non-important
205,10/01/2023,Books,true,3432982997703,3055.86,0.00,602245.37,Non-important
206,10/01/2023,Sports,true,3295537868130,583.27,0.00,601662.10,Non-important
207,10/01/2023,Shoes,false,3158782681594,0.00,59.85,601721.95,Important
208,10/01/2023,Grocery,true,3236900201022,1393.17,0.00,600328.78,Essential
209,10/01/2023,Books,true,3595535359081,2426.97,0.00,597901.81,Non-important
210,11/01/2023,Jewelry,true,3513899871688,4525.56,0.00,593376.25,Non-important
211,11/01/2023,Music,false,3087117743823,0.00,1272.62,594648.87,Essential
212,11/01/2023,Movies,true,3429418878999,4959.42,0.00,589689.45,Important
213,11/01/2023,Movies,true,3156502419105,2899.59,0.00,586789.86,Non-important
214,11/01/2023,Books,true,3221993473150,3665.74,0.00,583124.12,Non-Essential
215,11/01/2023,Sports,false,3478438649357,0.00,2864.33,585988.45,Essential
216,11/01/2023,Jewelry,false,3858761132834,0.00,7.20,585995.65,Non-important
217,11/01/2023,Electronics,false,3919378959243,0.00,2593.72,588589.37,Essential
218,11/01/2023,Electronics,true,3278330285125,3387.00,0.00,585202.37,Important
219,11/01/2023,Home,false,3445234240695,0.00,2632.36,587834.73,Essential
220,11/01/2023,Games,false,3116540959009,0.00,2384.14,590218.87,Non-Essential
221,11/01/2023,Industrial,true,3915564354445,317.93,0.00,589900.94,Essential
222,12/01/2023,Electronics,true,3650768210065,4993.89,0.00,584907.05,Non-Essential
223,12/01/2023,Books,true,3534823460140,2445.20,0.00,582461.85,Essential
224,12/01/2023,Music,false,3361794564682,0.00,2990.18,585452.03,Essential
225,12/01/2023,Automotive,false,3776761327817,0.00,813.25,586265.28,Essential
226,12/01/2023,Home,true,3610486843667,1731.65,0.00,584533.63,Non-Essential
227,12/01/2023,Kids,true,3620733590022,4110.27,0.00,580423.36,Non-Essential
228,12/01/2023,Kids,true,3028254195349,3206.16,0.00,577217.20,Essential
229,12/01/2023,Grocery,true,3636275991491,4803.23,0.00,572413.97,Essential
230,12/01/2023,Toys,false,3709613568135,0.00,20.28,572434.25,Non-important
231,12/01/2023,Kids,true,3434266619448,4895.61,0.00,567538.64,Essential
232,12/01/2023,Garden,false,3597956229781,0.00,35.79,567574.43,Essential
233,13/01/2023,Automotive,true,3200537889517,3256.90,0.00,564317.53,Essential
234,13/01/2023,Toys,false,3586951036308,0.00,1611.97,565929.50,Essential
235,13/01/2023,Outdoors,false,3433480287748,0.00,194.44,566123.94,Essential
236,13/01/2023,Computers,false,3779715105504,0.00,161.28,566285.22,Non-Essential
237,13/01/2023,Clothing,false,3202919923400,0.00,2026.14,568311.36,Non-important
238,13/01/2023,Kids,true,3136399544130,3004.94,0.00,565306.42,Essential
239,13/01/2023,Games,true,3607600160487,2699.57,0.00,562606.85,Essential
240,13/01/2023,Automotive,false,3933150106939,0.00,832.82,563439.67,Non-important
241,13/01/2023,Beauty,true,3073844279678,1417.46,0.00,562022.21,Important
242,14/01/2023,Music,true,3976682241065,927.75,0.00,561094.46,Non-Essential
243,14/01/2023,Kids,true,3751329061489,35.18,0.00,561059.28,Non-Essential
244,14/01/2023,Tools,false,3049570561902,0.00,1573.99,562633.27,Non-Essential
245,14/01/2023,Books,false,3311648787924,0.00,696.96,563330.23,Essential
246,14/01/2023,Kids,false,3978467483062,0.00,1686.97,565017.20,Non-Essential
247,14/01/2023,Grocery,false,3557166033124,0.00,2224.42,567241.62,Non-Essential
248,14/01/2023,Industrial,false,3557673819794,0.00,2816.88,570058.50,Non-important
249,14/01/2023,Movies,true,3624605737495,3658.48,0.00,566400.02,Essential
250,14/01/2023,Industrial,false,3571519607122,0.00,1402.41,567802.43,Non-Essential
251,14/01/2023,Beauty,false,3149624300556,0.00,435.32,568237.75,Important
252,14/01/2023,Garden,false,3184337340835,0.00,2604.22,570841.97,Non-important
253,14/01/2023,Kids,true,3348415246821,4324.78,0.00,566517.19,Non-Essential
254,15/01/2023,Baby,true,3412697166658,2127.41,0.00,564389.78,Non-Essential
255,15/01/2023,Health,false,3804387186852,0.00,2748.95,567138.73,Essential
256,15/01/2023,Music,true,3875430876882,4339.26,0.00,562799.47,Important
257,15/01/2023,Health,false,3622952726268,0.00,2781.28,565580.75,Essential
258,15/01/2023,Books,true,3787492522892,4405.82,0.00,561174.93,Non-Essential
259,15/01/2023,Jewelry,true,3616574385633,1076.45,0.00,560098.48,Non-Essential
260,15/01/2023,Industrial,false,3246017883897,0.00,2461.48,562559.96,Non-important
261,15/01/2023,Outdoors,false,3043562993308,0.00,2415.28,564975.24,Important
262,15/01/2023,Shoes,false,3612234215251,0.00,2141.05,567116.29,Non-important
263,15/01/2023,Electronics,false,3901701474150,0.00,2608.34,569724.63,Important
264,15/01/2023,Home,true,3757851408644,1396.92,0.00,568327.71,Non-Essential
265,15/01/2023,Movies,true,3639881292929,4773.41,0.00,563554.30,Non-important
266,15/01/2023,Games,false,3267419547271,0.00,430.56,563984.86,Essential
267,16/01/2023,Movies,true,3165473727403,3474.41,0.00,560510.45,Essential
268,16/01/2023,Movies,false,3377054863260,0.00,442.32,560952.77,Important
269,16/01/2023,Clothing,true,3380665293457,4187.57,0.00,556765.20,Non-Essential
270,16/01/2023,Shoes,false,3177232070876,0.00,52.29,556817.49,Non-Essential
271,16/01/2023,Garden,true,3676410052247,3371.04,0.00,553446.45,Non-Essential
272,16/01/2023,Sports,true,3855733434544,1877.90,0.00,551568.55,Non-important
273,16/01/2023,Tools,false,3416389760982,0.00,1399.23,552967.78,Important
274,16/01/2023,Shoes,true,3205845370277,2896.07,0.00,550071.71,Non-important
275,16/01/2023,Games,false,3343511170036,0.00,417.20,550488.91,Essential
276,17/01/2023,Health,true,3846917428098,889.14,0.00,549599.77,Important
277,17/01/2023,Movies,false,3914035448647,0.00,2121.72,551721.49,Non-Essential
278,17/01/2023,Home,true,3392850683762,221.08,0.00,551500.41,Non-Essential
279,17/01/2023,Clothing,true,3036672994336,722.53,0.00,550777.88,Non-important
280,17/01/2023,Movies,false,3983829428997,0.00,960.49,551738.37,Important
281,17/01/2023,Shoes,true,3376807817240,3351.33,0.00,548387.04,Important
282,17/01/2023,Movies,true,3783530088153,1317.43,0.00,547069.61,Essential
283,18/01/2023,Baby,true,3767312519727,1919.63,0.00,545149.98,Non-important
284,18/01/2023,Tools,false,3959283840896,0.00,2419.97,547569.95,Non-important
285,18/01/2023,Electronics,true,3797746378397,4631.59,0.00,542938.36,Non-Essential
286,18/01/2023,Garden,true,3585652241612,4150.57,0.00,538787.79,Non-important
287,18/01/2023,Tools,true,3771887263984,2052.16,0.00,536735.63,Important
288,18/01/2023,Computers,false,3913528720623,0.00,2217.58,538953.21,Non-important
289,18/01/2023,Jewelry,false,3501162341598,0.00,557.90,539511.11,Non-important
290,18/01/2023,Toys,true,3792427928202,4313.00,0.00,535198.11,Non-Essential
291,18/01/2023,Games,true,3479327434300,3829.89,0.00,531368.22,Non-Essential
292,18/01/2023,Home,true,3189988721883,749.43,0.00,530618.79,Important
293,18/01/2023,Grocery,false,3991691621741,0.00,1877.53,532496.32,Important
294,18/01/2023,Industrial,false,3713105397228,0.00,2577.70,535074.02,Non-important
295,18/01/2023,Sports,true,3984294920610,4522.61,0.00,530551.41,Non-important
296,18/01/2023,Tools,true,3627140918404,1516.33,0.00,529035.08,Non-important
297,18/01/2023,Garden,true,3428771848603,4216.57,0.00,524818.51,Non-important
298,18/01/2023,Kids,true,3843499442682,686.44,0.00,524132.07,Non-important
299,19/01/2023,Shoes,false,3532431677634,0.00,427.23,524559.30,Essential
300,19/01/2023,Grocery,true,3677258851066,4283.31,0.00,520275.99,Non-important
301,19/01/2023,Health,true,3932497092034,3075.72,0.00,517200.27,Important
302,19/01/2023,Grocery,true,3441910304522,3986.78,0.00,513213.49,Non-Essential
303,19/01/2023,Music,true,3657881856923,1264.48,0.00,511949.01,Essential
304,19/01/2023,Games,false,3529159372225,0.00,1054.47,513003.48,Essential
305,20/01/2023,Kids,false,3005345531757,0.00,862.15,513865.63,Essential
306,20/01/2023,Toys,true,3382616841311,2968.07,0.00,510897.56,Essential
307,20/01/2023,Jewelry,false,3346559432434,0.00,1833.91,512731.47,Non-Essential
308,20/01/2023,Grocery,true,3458990007994,4736.69,0.00,507994.78,Non-important
309,20/01/2023,Sports,false,3995318608382,0.00,185.08,508179.86,Essential
310,20/01/2023,Toys,false,3519231791075,0.00,476.20,508656.06,Important
311,20/01/2023,Home,true,3174790627387,3018.15,0.00,505637.91,Essential
312,20/01/2023,Computers,false,3656879395423,0.00,2881.65,508519.56,Essential
313,20/01/2023,Industrial,false,3473027948101,0.00,2439.90,510959.46,Non-Essential
314,21/01/2023,Books,true,3325312290954,3933.09,0.00,507026.37,Non-Essential
315,21/01/2023,Movies,true,3469925079478,191.22,0.00,506835.15,Essential
316,21/01/2023,Baby,false,3554335600452,0.00,2424.55,509259.70,Essential
317,21/01/2023,Music,true,3687241455755,1960.17,0.00,507299.53,Important
318,21/01/2023,Kids,true,3689076881079,2195.76,0.00,505103.77,Essential
319,21/01/2023,Kids,true,3975317038121,2181.82,0.00,502921.95,Essential
320,21/01/2023,Computers,true,3957581308263,1028.10,0.00,501893.85,Non-Essential
321,21/01/2023,Sports,false,3272505317568,0.00,2014.03,503907.88,Important
322,21/01/2023,Baby,true,3869384013244,2190.25,0.00,501717.63,Essential
323,21/01/2023,Movies,false,3385328603689,0.00,406.26,502123.89,Important
324,22/01/2023,Health,true,3413212229567,4282.93,0.00,497840.96,Non-Essential
325,22/01/2023,Shoes,false,3387800924944,0.00,1624.78,499465.74,Important
326,22/01/2023,Baby,false,3456543348774,0.00,1925.48,501391.22,Non-Essential
327,22/01/2023,Shoes,false,3664158073626,0.00,1387.44,502778.66,Non-Essential
328,22/01/2023,Sports,false,3811429988972,0.00,2805.10,505583.76,Non-important
329,22/01/2023,Books,false,3589775698230,0.00,1908.95,507492.71,Important
330,22/01/2023,Computers,true,3346936248567,536.26,0.00,506956.45,Essential
331,22/01/2023,Clothing,true,3708397898845,1018.82,0.00,505937.63,Important
332,22/01/2023,Jewelry,false,3403621075037,0.00,1594.91,507532.54,Non-important
333,22/01/2023,Home,true,3107021319411,1320.56,0.00,506211.98,Non-important
334,23/01/2023,Industrial,false,3873723049204,0.00,1257.37,507469.35,Important
335,23/01/2023,Electronics,true,3190028254348,422.56,0.00,507046.79,Essential
336,23/01/2023,Baby,false,3715197852521,0.00,1431.90,508478.69,Important
337,23/01/2023,Jewelry,false,3463937812412,0.00,1321.52,509800.21,Non-important
338,23/01/2023,Computers,false,3355121082568,0.00,390.02,510190.23,Non-important
339,23/01/2023,Baby,true,3154215151144,2104.51,0.00,508085.72,Non-important
340,23/01/2023,Home,false,3890624544467,0.00,1659.24,509744.96,Essential
341,23/01/2023,Shoes,false,3443593749404,0.00,1268.83,511013.79,Non-Essential
342,23/01/2023,Health,true,3542015435024,2918.19,0.00,508095.60,Important
343,23/01/2023,Music,true,3695992782612,3739.69,0.00,504355.91,Non-important
344,24/01/2023,Computers,true,3600529507047,451.17,0.00,503904.74,Important
345,24/01/2023,Jewelry,false,3460396193281,0.00,680.38,504585.12,Non-important
346,24/01/2023,Industrial,true,3352039132553,2188.24,0.00,502396.88,Important
347,24/01/2023,Games,false,3135190555273,0.00,261.04,502657.92,Non-important
348,24/01/2023,Tools,true,3065242360568,1027.68,0.00,501630.24,Important
349,24/01/2023,Clothing,true,3471761993415,1202.29,0.00,500427.95,Non-Essential
350,24/01/2023,Computers,false,3590247587771,0.00,2662.32,503090.27,Non-Essential
351,24/01/2023,Baby,false,3088168095372,0.00,2853.81,505944.08,Essential
352,24/01/2023,Beauty,false,3248842972427,0.00,1745.84,507689.92,Non-Essential
353,25/01/2023,Garden,false,3973597299336,0.00,1630.09,509320.01,Important
354,25/01/2023,Baby,true,3847315766153,4262.37,0.00,505057.64,Essential
355,25/01/2023,Home,false,3205821847217,0.00,1410.17,506467.81,Non-important
356,25/01/2023,Shoes,false,3388760411072,0.00,1255.13,507722.94,Essential
357,25/01/2023,Sports,false,3314093309246,0.00,1600.15,509323.09,Non-Essential
358,25/01/2023,Movies,false,3216406595303,0.00,1951.27,511274.36,Important
359,25/01/2023,Clothing,false,3841032324466,0.00,107.22,511381.58,Important
360,25/01/2023,Computers,true,3884424222058,2543.53,0.00,508838.05,Essential
361,25/01/2023,Movies,false,3856620732042,0.00,1987.01,510825.06,Non-Essential
362,25/01/2023,Shoes,true,3109464112562,2687.31,0.00,508137.75,Non-Essential
363,26/01/2023,Industrial,false,3950434842013,0.00,1509.96,509647.71,Non-Essential
364,26/01/2023,Grocery,true,3080924790997,4857.39,0.00,504790.32,Important
365,26/01/2023,Outdoors,true,3041912290411,1087.11,0.00,503703.21,Important
366,26/01/2023,Kids,false,3409029273973,0.00,371.68,504074.89,Non-Essential
367,26/01/2023,Home,true,3565485589437,3962.90,0.00,500111.99,Essential
368,26/01/2023,Tools,false,3382052598623,0.00,277.96,500389.95,Important
369,26/01/2023,Home,true,3603183067662,4598.03,0.00,495791.92,Non-Essential
370,26/01/2023,Home,false,3041207821118,0.00,980.71,496772.63,Non-important
371,26/01/2023,Beauty,true,3287559291442,222.29,0.00,496550.34,Non-important
372,26/01/2023,Baby,true,3172359317633,153.45,0.00,496396.89,Important
373,26/01/2023,Movies,true,3318810498019,3419.75,0.00,492977.14,Essential
374,26/01/2023,Games,false,3171368900859,0.00,221.57,493198.71,Important
375,26/01/2023,Garden,true,3716558943925,3488.52,0.00,489710.19,Essential
376,27/01/2023,Movies,true,3962235995819,855.46,0.00,488854.73,Non-Essential
377,27/01/2023,Movies,true,3989613140247,1271.55,0.00,487583.18,Important
378,27/01/2023,Books,false,3526549746838,0.00,2338.68,489921.86,Important
379,27/01/2023,Tools,true,3836212417020,3602.58,0.00,486319.28,Non-Essential
380,27/01/2023,Industrial,false,3408882075345,0.00,2259.11,488578.39,Important
381,27/01/2023,Tools,false,3822401324750,0.00,543.17,489121.56,Essential
382,27/01/2023,Jewelry,false,3182837528137,0.00,2793.35,491914.91,Non-important
383,27/01/2023,Grocery,true,3501610364813,4711.20,0.00,487203.71,Non-important
384,27/01/2023,Clothing,false,3766344639497,0.00,2093.93,489297.64,Important
385,27/01/2023,Beauty,false,3261162994242,0.00,265.04,489562.68,Non-Essential
386,27/01/2023,Toys,false,3031859403699,0.00,2104.38,491667.06,Non-Essential
387,28/01/2023,Automotive,false,3359589277716,0.00,90.38,491757.44,Essential
388,28/01/2023,Electronics,true,3944476476829,4302.73,0.00,487454.71,Non-important
389,28/01/2023,Kids,false,3456102883050,0.00,1095.25,488549.96,Important
390,28/01/2023,Electronics,true,3555441828251,3174.45,0.00,485375.51,Important
391,28/01/2023,Tools,true,3636405035659,671.85,0.00,484703.66,Important
392,28/01/2023,Clothing,false,3618580024844,0.00,140.48,484844.14,Essential
393,28/01/2023,Games,false,3287668803864,0.00,1579.72,486423.86,Non-important
394,28/01/2023,Books,false,3319594500297,0.00,668.57,487092.43,Important
395,29/01/2023,Tools,false,3247899844834,0.00,2410.50,489502.93,Non-Essential
396,29/01/2023,Computers,false,3779912537178,0.00,914.44,490417.37,Essential
397,29/01/2023,Shoes,true,3369724344001,3825.21,0.00,486592.16,Important
398,29/01/2023,Electronics,false,3940463595719,0.00,1594.38,488186.54,Essential
399,29/01/2023,Sports,false,3950569708201,0.00,2794.11,490980.65,Non-important
400,29/01/2023,Automotive,true,3932447591459,4750.80,0.00,486229.85,Non-Essential
401,30/01/2023,Kids,false,3571996260551,0.00,2681.84,488911.69,Non-important
402,30/01/2023,Baby,false,3122696816230,0.00,161.81,489073.50,Important
403,30/01/2023,Jewelry,true,3246115605715,3807.36,0.00,485266.14,Important
404,30/01/2023,Jewelry,true,3483839930582,2696.62,0.00,482569.52,Important
405,30/01/2023,Tools,true,3589831116528,1049.30,0.00,481520.22,Non-Essential
406,30/01/2023,Garden,false,3441686367840,0.00,180.38,481700.60,Non-Essential
407,30/01/2023,Industrial,true,3688263531133,2544.13,0.00,479156.47,Non-Essential
408,30/01/2023,Movies,true,3301912487545,4118.41,0.00,475038.06,Non-Essential
409,30/01/2023,Music,true,3910828220503,947.26,0.00,474090.80,Non-Essential
410,30/01/2023,Games,true,3683918103299,1784.77,0.00,472306.03,Non-important
411,30/01/2023,Industrial,false,3084468783270,0.00,274.19,472580.22,Non-important
412,30/01/2023,Home,false,3101350345083,0.00,617.17,473197.39,Non-important
413,30/01/2023,Movies,false,3194650902164,0.00,1334.25,474531.64,Non-important
414,31/01/2023,Outdoors,false,3334178620111,0.00,464.73,474996.37,Important
415,31/01/2023,Kids,true,3724858559626,3309.60,0.00,471686.77,Essential
416,31/01/2023,Shoes,false,3133779798942,0.00,219.27,471906.04,Essential
417,31/01/2023,Tools,true,3561023941406,2993.24,0.00,468912.80,Essential
418,31/01/2023,Outdoors,true,3580548152458,2032.43,0.00,466880.37,Non-Essential
419,31/01/2023,Garden,true,3236323595340,4441.32,0.00,462439.05,Non-Essential
420,31/01/2023,Sports,false,3955943114365,0.00,109.06,462548.11,Non-Essential
421,31/01/2023,Garden,false,3182586486156,0.00,157.61,462705.72,Non-Essential
422,31/01/2023,Sports,false,3025402052410,0.00,2364.69,465070.41,Non-important
423,31/01/2023,Clothing,false,3718122270101,0.00,2987.33,468057.74,Non-Essential
424,31/01/2023,Home,false,3939352043442,0.00,1295.19,469352.93,Non-important
425,01/02/2023,Music,false,3724165445240,0.00,2871.65,472224.58,Non-important
426,01/02/2023,Beauty,true,3627231253148,3843.36,0.00,468381.22,Important
427,01/02/2023,Music,false,3265694704272,0.00,2663.22,471044.44,Non-Essential
428,01/02/2023,Home,true,3363688215206,4781.64,0.00,466262.80,Non-Essential
429,01/02/2023,Electronics,false,3149501727334,0.00,812.10,467074.90,Non-important
430,01/02/2023,Grocery,false,3114379450307,0.00,431.15,467506.05,Non-important
431,01/02/2023,Jewelry,false,3808045515627,0.00,927.48,468433.53,Essential
432,01/02/2023,Sports,false,3296716455178,0.00,399.18,468832.71,Non-Essential
433,02/02/2023,Music,true,3511418136634,2376.00,0.00,466456.71,Non-Essential
434,02/02/2023,Sports,true,3809316161331,2315.56,0.00,464141.15,Important
435,02/02/2023,Home,false,3620618986289,0.00,607.22,464748.37,Non-important
436,02/02/2023,Books,true,3071211029502,1065.63,0.00,463682.74,Important
437,02/02/2023,Industrial,true,3071416257025,4022.05,0.00,459660.69,Non-important
438,02/02/2023,Music,true,3047105841305,824.88,0.00,458835.81,Non-Essential
439,02/02/2023,Garden,true,3190993974883,3066.95,0.00,455768.86,Essential
440,03/02/2023,Movies,false,3280251434911,0.00,2831.78,458600.64,Non-Essential
441,03/02/2023,Health,false,3954670847432,0.00,1215.58,459816.22,Essential
442,03/02/2023,Toys,true,3597490936516,4837.58,0.00,454978.64,Important
443,03/02/2023,Health,false,3878309927287,0.00,2439.57,457418.21,Essential
444,03/02/2023,Tools,false,3187709817774,0.00,1040.80,458459.01,Important
445,03/02/2023,Home,true,3960057066206,3000.55,0.00,455458.46,Important
446,03/02/2023,Kids,true,3785661858227,2247.21,0.00,453211.25,Important
447,03/02/2023,Outdoors,true,3309439249792,1144.63,0.00,452066.62,Important
448,03/02/2023,Jewelry,true,3993875141871,4407.13,0.00,447659.49,Important
449,04/02/2023,Movies,true,3022639909092,3104.90,0.00,444554.59,Non-important
450,04/02/2023,Toys,true,3708669216383,3318.80,0.00,441235.79,Important
451,04/02/2023,Kids,true,3483243350020,1744.78,0.00,439491.01,Non-important
452,04/02/2023,Grocery,true,3792963077068,2079.50,0.00,437411.51,Non-Essential
453,04/02/2023,Grocery,false,3533941354098,0.00,355.76,437767.27,Non-important
454,04/02/2023,Sports,true,3603561576461,1076.93,0.00,436690.34,Non-important
455,04/02/2023,Electronics,true,3900772877824,1000.36,0.00,435689.98,Non-Essential
456,04/02/2023,Tools,false,3539925733729,0.00,2883.71,438573.69,Essential
457,04/02/2023,Grocery,true,3254800576354,4375.35,0.00,434198.34,Important
458,05/02/2023,Movies,true,3522580535179,87.49,0.00,434110.85,Essential
459,05/02/2023,Books,false,3674844900930,0.00,1350.56,435461.41,Non-important
460,05/02/2023,Clothing,false,3108945993319,0.00,2890.12,438351.53,Essential
461,05/02/2023,Baby,true,3881226140042,871.64,0.00,437479.89,Essential
462,05/02/2023,Home,true,3226799998116,2930.73,0.00,434549.16,Essential
463,05/02/2023,Industrial,false,3545011763187,0.00,1112.13,435661.29,Non-important
464,05/02/2023,Music,false,3305860386836,0.00,1233.53,436894.82,Essential
465,05/02/2023,Automotive,true,3836343022296,56.41,0.00,436838.41,Non-important
466,05/02/2023,Automotive,true,3156926511737,4754.58,0.00,432083.83,Essential
467,05/02/2023,Kids,false,3251917973197,0.00,41.05,432124.88,Non-important
468,05/02/2023,Beauty,true,3095045655023,4800.15,0.00,427324.73,Essential
469,06/02/2023,Toys,true,3436746714336,3589.59,0.00,423735.14,Non-important
470,06/02/2023,Computers,false,3787816011228,0.00,1146.25,424881.39,Important
471,06/02/2023,Clothing,true,3734986237373,391.44,0.00,424489.95,Important
472,06/02/2023,Tools,true,3427454981515,3798.79,0.00,420691.16,Essential
473,06/02/2023,Grocery,false,3666367848115,0.00,1716.69,422407.85,Important
474,06/02/2023,Games,true,3445162553550,4658.39,0.00,417749.46,Essential
475,06/02/2023,Outdoors,true,3087861156544,3227.76,0.00,414521.70,Non-important
476,06/02/2023,Tools,true,3244750407726,1601.71,0.00,412919.99,Non-important
477,06/02/2023,Industrial,true,3283765060353,3191.27,0.00,409728.72,Non-important
478,06/02/2023,Baby,false,3332892366339,0.00,1610.67,411339.39,Non-Essential
479,06/02/2023,Sports,true,3230977102869,1513.16,0.00,409826.23,Non-Essential
480,06/02/2023,Baby,true,3622550316910,1657.94,0.00,408168.29,Non-Essential
481,06/02/2023,Garden,true,3021056535261,2328.60,0.00,405839.69,Non-Essential
482,06/02/2023,Health,false,3976630087452,0.00,1697.91,407537.60,Important
483,06/02/2023,Shoes,true,3278725099659,2767.34,0.00,404770.26,Non-important
484,07/02/2023,Tools,false,3494832918450,0.00,2491.01,407261.27,Non-important
485,07/02/2023,Home,true,3522598682259,2751.51,0.00,404509.76,Essential
486,07/02/2023,Automotive,false,3213617270074,0.00,1645.60,406155.36,Non-Essential
487,07/02/2023,Electronics,true,3956501876469,3287.78,0.00,402867.58,Essential
488,07/02/2023,Beauty,false,3700400666253,0.00,800.69,403668.27,Non-Essential
489,07/02/2023,Jewelry,false,3318252119102,0.00,1506.56,405174.83,Non-Essential
490,07/02/2023,Health,false,3139958723525,0.00,1292.54,406467.37,Important
491,07/02/2023,Movies,false,3197374159612,0.00,2524.18,408991.55,Important
492,07/02/2023,Movies,true,3864937735670,1198.93,0.00,407792.62,Essential
493,07/02/2023,Grocery,true,3722430142474,4266.00,0.00,403526.62,Non-important
494,07/02/2023,Home,true,3947919211470,11.99,0.00,403514.63,Important
495,07/02/2023,Health,false,3058778817526,0.00,1272.32,404786.95,Non-important
496,08/02/2023,Industrial,true,3712735983480,4124.32,0.00,400662.63,Important
497,08/02/2023,Industrial,false,3377702594762,0.00,2099.54,402762.17,Non-Essential
498,08/02/2023,Automotive,true,3915166480256,2329.24,0.00,400432.93,Important
499,08/02/2023,Home,false,3715646944156,0.00,2595.63,403028.56,Non-important
500,08/02/2023,Music,false,3101229347978,0.00,690.89,403719.45,Non-important
501,08/02/2023,Grocery,false,3818805181839,0.00,210.57,403930.02,Non-important
502,08/02/2023,Outdoors,true,3461557877278,189.11,0.00,403740.91,Non-Essential
503,08/02/2023,Games,false,3965783217786,0.00,235.03,403975.94,Essential
504,08/02/2023,Grocery,false,3720503236624,0.00,2229.96,406205.90,Important
505,08/02/2023,Sports,true,3010815975424,4827.09,0.00,401378.81,Essential
506,09/02/2023,Books,true,3317266071671,4587.87,0.00,396790.94,Non-Essential
507,09/02/2023,Home,false,3380773431656,0.00,890.93,397681.87,Non-Essential
508,09/02/2023,Sports,false,3977615116914,0.00,1756.55,399438.42,Essential
509,09/02/2023,Beauty,true,3493341060832,1252.10,0.00,398186.32,Essential
510,09/02/2023,Books,true,3131071972139,4825.50,0.00,393360.82,Non-Essential
511,09/02/2023,Beauty,false,3848828010915,0.00,329.86,393690.68,Non-important
512,09/02/2023,Movies,false,3462832170750,0.00,310.13,394000.81,Important
513,09/02/2023,Tools,false,3856238929967,0.00,99.13,394099.94,Non-important
514,09/02/2023,Games,true,3788204906574,646.65,0.00,393453.29,Non-Essential
515,09/02/2023,Shoes,true,3200398805519,2000.25,0.00,391453.04,Important
516,09/02/2023,Music,false,3074462422048,0.00,2550.51,394003.55,Essential
517,09/02/2023,Clothing,true,3379302441153,3085.75,0.00,390917.80,Non-Essential
518,09/02/2023,Sports,false,3113245678141,0.00,623.45,391541.25,Non-important
519,10/02/2023,Electronics,true,3310478580253,3503.20,0.00,388038.05,Essential
520,10/02/2023,Kids,false,3682399518045,0.00,1763.56,389801.61,Essential
521,10/02/2023,Books,true,3859339593737,4965.73,0.00,384835.88,Essential
522,10/02/2023,Games,true,3396133977479,1995.80,0.00,382840.08,Essential
523,10/02/2023,Tools,true,3999384978986,1425.07,0.00,381415.01,Important
524,10/02/2023,Jewelry,true,3100423578132,4437.77,0.00,376977.24,Non-Essential
525,10/02/2023,Kids,true,3194231840338,904.06,0.00,376073.18,Essential
526,10/02/2023,Toys,true,3484449288072,4841.67,0.00,371231.51,Important
527,11/02/2023,Clothing,true,3176820721820,3168.01,0.00,368063.50,Important
528,11/02/2023,Home,false,3592257492359,0.00,2503.12,370566.62,Non-Essential
529,11/02/2023,Kids,true,3803248237130,3310.17,0.00,367256.45,Non-important
530,11/02/2023,Baby,false,3467729473191,0.00,696.23,367952.68,Important
531,11/02/2023,Kids,false,3884100095013,0.00,2838.96,370791.64,Important
532,11/02/2023,Health,false,3980718078825,0.00,1756.95,372548.59,Essential
533,11/02/2023,Shoes,false,3543108545906,0.00,2034.58,374583.17,Non-important
534,11/02/2023,Industrial,false,3243356559340,0.00,1795.49,376378.66,Important
535,12/02/2023,Jewelry,false,3682430832943,0.00,1074.74,377453.40,Important
536,12/02/2023,Outdoors,true,3572830348325,4528.50,0.00,372924.90,Essential
537,12/02/2023,Home,true,3048785656415,3107.42,0.00,369817.48,Important
538,12/02/2023,Music,false,3142502187213,0.00,37.35,369854.83,Non-important
539,12/02/2023,Toys,false,3532329202726,0.00,1633.04,371487.87,Important
540,12/02/2023,Garden,true,3006428162320,197.81,0.00,371290.06,Non-important
541,12/02/2023,Beauty,true,3065297237083,3666.02,0.00,367624.04,Important
542,12/02/2023,Clothing,false,3473345053178,0.00,2633.68,370257.72,Essential
543,12/02/2023,Toys,true,3465830359059,744.48,0.00,369513.24,Important
544,12/02/2023,Toys,true,3486536099814,3972.62,0.00,365540.62,Essential
545,12/02/2023,Movies,false,3900780542615,0.00,2412.37,367952.99,Essential
546,13/02/2023,Computers,true,3450369967795,1416.55,0.00,366536.44,Important
547,13/02/2023,Computers,false,3069473069809,0.00,2881.56,369418.00,Non-Essential
548,13/02/2023,Grocery,false,3758364195854,0.00,493.24,369911.24,Non-important
549,13/02/2023,Music,true,3558793933058,1689.92,0.00,368221.32,Essential
550,13/02/2023,Outdoors,true,3008042692821,3689.90,0.00,364531.42,Important
551,13/02/2023,Games,true,3818350951817,4005.45,0.00,360525.97,Non-important
552,13/02/2023,Shoes,true,3379895457443,2196.09,0.00,358329.88,Non-Essential
553,13/02/2023,Movies,true,3493612640333,3682.13,0.00,354647.75,Essential
554,13/02/2023,Baby,false,3218605344034,0.00,2912.42,357560.17,Non-important
555,14/02/2023,Baby,false,3579754299121,0.00,2761.53,360321.70,Non-important
556,14/02/2023,Music,false,3488089789643,0.00,2201.99,362523.69,Essential
557,14/02/2023,Games,true,3053315869834,1323.46,0.00,361200.23,Non-important
558,14/02/2023,Jewelry,true,3157253920612,3395.01,0.00,357805.22,Non-Essential
559,14/02/2023,Garden,true,3565566966805,4540.66,0.00,353264.56,Essential
560,14/02/2023,Games,false,3438730135310,0.00,2095.50,355360.06,Important
561,14/02/2023,Music,true,3557911616975,3389.70,0.00,351970.36,Essential
562,14/02/2023,Shoes,true,3826098129227,3466.73,0.00,348503.63,Non-important
563,14/02/2023,Tools,false,3685109822644,0.00,19.95,348523.58,Important
564,15/02/2023,Health,true,3479835311827,4640.39,0.00,343883.19,Important
565,15/02/2023,Jewelry,false,3341369088426,0.00,2420.14,346303.33,Non-Essential
566,15/02/2023,Music,false,3758596414302,0.00,2176.13,348479.46,Important
567,15/02/2023,Kids,false,3014736216199,0.00,2741.58,351221.04,Essential
568,15/02/2023,Industrial,true,3513675890224,3300.45,0.00,347920.59,Important
569,15/02/2023,Clothing,false,3322865853650,0.00,426.77,348347.36,Important
570,15/02/2023,Garden,false,3973973998826,0.00,121.36,348468.72,Essential
571,15/02/2023,Garden,true,3825119688959,884.03,0.00,347584.69,Non-important
572,15/02/2023,Games,false,3145834824145,0.00,2317.33,349902.02,Essential
573,15/02/2023,Kids,true,3579345082588,348.74,0.00,349553.28,Essential
574,15/02/2023,Health,true,3977705040949,2830.12,0.00,346723.16,Essential
575,15/02/2023,Shoes,false,3119575107196,0.00,2461.91,349185.07,Non-important
576,15/02/2023,Music,false,3897474983236,0.00,2960.82,352145.89,Non-Essential
577,15/02/2023,Music,false,3364941035172,0.00,1423.62,353569.51,Non-Essential
578,15/02/2023,Games,true,3365579051847,4658.80,0.00,348910.71,Non-Essential
579,15/02/2023,Health,true,3647295755987,568.76,0.00,348341.95,Non-important
580,16/02/2023,Beauty,false,3704762027871,0.00,2401.06,350743.01,Non-Essential
581,16/02/2023,Automotive,false,3424982128555,0.00,4.11,350747.12,Non-Essential
582,16/02/2023,Toys,true,3046745253345,1342.88,0.00,349404.24,Non-important
583,16/02/2023,Music,true,3759182432947,2481.26,0.00,346922.98,Important
584,16/02/2023,Tools,false,3540744664408,0.00,1509.65,348432.63,Important
585,16/02/2023,Health,false,3777260092996,0.00,1290.96,349723.59,Important
586,16/02/2023,Clothing,false,3366642005768,0.00,593.10,350316.69,Non-Essential
587,16/02/2023,Garden,false,3894890743769,0.00,1349.73,351666.42,Essential
588,16/02/2023,Baby,false,3188051670730,0.00,865.20,352531.62,Important
589,16/02/2023,Home,true,3021713080438,494.46,0.00,352037.16,Important
590,16/02/2023,Outdoors,false,3077950083782,0.00,329.34,352366.50,Non-important
591,16/02/2023,Books,false,3582897778163,0.00,2346.12,354712.62,Non-important
592,16/02/2023,Electronics,true,3732486751847,1830.12,0.00,352882.50,Non-important
593,16/02/2023,Movies,false,3633507507947,0.00,651.00,353533.50,Non-Essential
594,16/02/2023,Music,true,3743518991153,2204.90,0.00,351328.60,Non-important
595,16/02/2023,Movies,false,3019774468412,0.00,2999.78,354328.38,Non-Essential
596,17/02/2023,Health,false,3275772918655,0.00,2169.02,356497.40,Non-Essential
597,17/02/2023,Shoes,true,3741813921048,3538.14,0.00,352959.26,Non-important
598,17/02/2023,Sports,true,3513974100319,2358.27,0.00,350600.99,Important
599,17/02/2023,Clothing,false,3915559146068,0.00,683.66,351284.65,Non-important
600,17/02/2023,Beauty,false,3325565626326,0.00,643.99,351928.64,Essential
601,17/02/2023,Jewelry,false,3624347370576,0.00,1769.44,353698.08,Important
602,17/02/2023,Health,true,3657331286152,2655.12,0.00,351042.96,Essential
603,17/02/2023,Clothing,false,3839938615897,0.00,483.85,351526.81,Essential
604,17/02/2023,Music,true,3986840786536,2972.45,0.00,348554.36,Non-Essential
605,18/02/2023,Beauty,true,3074178686189,3564.53,0.00,344989.83,Non-Essential
606,18/02/2023,Computers,true,3924879869837,761.92,0.00,344227.91,Non-Essential
607,18/02/2023,Industrial,true,3688103601374,1040.32,0.00,343187.59,Important
608,18/02/2023,Health,false,3752041604732,0.00,995.72,344183.31,Non-important
609,18/02/2023,Baby,false,3080156919591,0.00,1792.63,345975.94,Essential
610,18/02/2023,Books,false,3012675712876,0.00,2040.60,348016.54,Non-Essential
611,18/02/2023,Outdoors,true,3092928904225,3278.01,0.00,344738.53,Non-Essential
612,18/02/2023,Baby,false,3538207200988,0.00,324.64,345063.17,Non-important
613,18/02/2023,Clothing,false,3147490464493,0.00,2251.94,347315.11,Important
614,19/02/2023,Home,false,3347611863669,0.00,524.86,347839.97,Non-important
615,19/02/2023,Books,true,3308862502811,4684.94,0.00,343155.03,Essential
616,19/02/2023,Sports,true,3745643074149,3637.50,0.00,339517.53,Non-important
617,19/02/2023,Industrial,true,3814423024073,2256.69,0.00,337260.84,Non-Essential
618,19/02/2023,Books,false,3386303492329,0.00,1809.88,339070.72,Important
619,19/02/2023,Computers,false,3829425558133,0.00,2773.27,341843.99,Important
620,19/02/2023,Grocery,true,3175725865441,1355.47,0.00,340488.52,Important
621,19/02/2023,Shoes,false,3529941590406,0.00,2095.90,342584.42,Essential
622,19/02/2023,Jewelry,true,3944081060802,1861.78,0.00,340722.64,Essential
623,19/02/2023,Baby,true,3356178103162,1572.86,0.00,339149.78,Non-Essential
624,19/02/2023,Baby,false,3682655208261,0.00,2025.94,341175.72,Important
625,19/02/2023,Automotive,false,3235576759519,0.00,1025.36,342201.08,Non-Essential
626,19/02/2023,Baby,false,3513594085585,0.00,1782.45,343983.53,Essential
627,19/02/2023,Clothing,false,3610852419522,0.00,392.71,344376.24,Non-important
628,19/02/2023,Kids,true,3105645609000,1181.93,0.00,343194.31,Essential
629,19/02/2023,Industrial,true,3055470452157,3280.22,0.00,339914.09,Important
630,19/02/2023,Automotive,false,3562302941206,0.00,2836.94,342751.03,Non-Essential
631,20/02/2023,Health,false,3547136282471,0.00,1114.95,343865.98,Non-Essential
632,20/02/2023,Industrial,false,3075855072547,0.00,2100.35,345966.33,Non-Essential
633,20/02/2023,Toys,false,3253793721669,0.00,1742.65,347708.98,Non-Essential
634,20/02/2023,Beauty,false,3466311994066,0.00,2133.30,349842.28,Important
635,20/02/2023,Clothing,true,3499642412100,816.39,0.00,349025.89,Essential
636,20/02/2023,Books,false,3017061260173,0.00,764.04,349789.93,Important
637,20/02/2023,Toys,false,3090696317119,0.00,2769.75,352559.68,Important
638,20/02/2023,Computers,false,3243907080020,0.00,737.58,353297.26,Essential
639,20/02/2023,Grocery,false,3006834202694,0.00,936.92,354234.18,Non-Essential
640,21/02/2023,Sports,true,3614890057618,1405.98,0.00,352828.20,Non-important
641,21/02/2023,Movies,false,3254900529422,0.00,2722.69,355550.89,Non-Essential
642,21/02/2023,Outdoors,false,3278536774072,0.00,664.80,356215.69,Important
643,21/02/2023,Clothing,true,3878027482166,4502.19,0.00,351713.50,Important
644,21/02/2023,Clothing,true,3311720386314,3425.57,0.00,348287.93,Important
645,21/02/2023,Books,false,3684839708486,0.00,1847.93,350135.86,Important
646,21/02/2023,Games,false,3312859065058,0.00,152.74,350288.60,Non-important
647,21/02/2023,Sports,false,3075396898876,0.00,554.56,350843.16,Essential
648,21/02/2023,Games,true,3820797190553,784.24,0.00,350058.92,Essential
649,21/02/2023,Electronics,false,3137095346586,0.00,2425.01,352483.93,Non-Essential
650,21/02/2023,Computers,true,3882600899894,555.71,0.00,351928.22,Non-important
651,21/02/2023,Industrial,true,3737098284177,1794.58,0.00,350133.64,Important
652,21/02/2023,Music,false,3554358842731,0.00,1130.12,351263.76,Important
653,21/02/2023,Music,false,3478734918598,0.00,909.15,352172.91,Non-Essential
654,22/02/2023,Electronics,true,3514354487922,2330.82,0.00,349842.09,Non-Essential
655,22/02/2023,Toys,false,3485954092266,0.00,2824.80,352666.89,Non-important
656,22/02/2023,Games,true,3728574150227,3722.71,0.00,348944.18,Essential
657,22/02/2023,Games,true,3066317109124,3926.55,0.00,345017.63,Non-important
658,22/02/2023,Jewelry,false,3651420266523,0.00,2941.79,347959.42,Essential
659,22/02/2023,Books,true,3280741681047,4523.03,0.00,343436.39,Non-Essential
660,22/02/2023,Computers,true,3541208624590,4219.86,0.00,339216.53,Important
661,22/02/2023,Books,false,3364765378857,0.00,649.74,339866.27,Important
662,22/02/2023,Sports,true,3440855131528,4012.41,0.00,335853.86,Non-important
663,22/02/2023,Tools,true,3673505439082,1943.56,0.00,333910.30,Essential
664,22/02/2023,Books,false,3967344275886,0.00,1973.54,335883.84,Essential
665,22/02/2023,Toys,true,3914675087440,2117.71,0.00,333766.13,Non-Essential
666,22/02/2023,Home,true,3975289837292,1364.04,0.00,332402.09,Non-important
667,23/02/2023,Outdoors,true,3486661219335,936.51,0.00,331465.58,Non-important
668,23/02/2023,Movies,false,3313765641170,0.00,204.71,331670.29,Non-important
669,23/02/2023,Home,true,3701077158957,3273.79,0.00,328396.50,Essential
670,23/02/2023,Books,false,3246471994574,0.00,1311.25,329707.75,Non-important
671,23/02/2023,Sports,true,3171340641952,2674.43,0.00,327033.32,Essential
672,23/02/2023,Sports,true,3750250773505,4401.12,0.00,322632.20,Important
673,23/02/2023,Health,true,3498844189330,1284.84,0.00,321347.36,Non-Essential
674,23/02/2023,Computers,true,3891638060094,654.01,0.00,320693.35,Non-Essential
675,23/02/2023,Clothing,false,3843554428686,0.00,1040.27,321733.62,Non-important
676,23/02/2023,Grocery,false,3834135797104,0.00,1124.10,322857.72,Essential
677,23/02/2023,Clothing,true,3942096317229,2055.44,0.00,320802.28,Important
678,23/02/2023,Beauty,true,3087412770557,1143.26,0.00,319659.02,Non-Essential
679,23/02/2023,Outdoors,false,3777168896904,0.00,2043.49,321702.51,Non-Essential
680,23/02/2023,Movies,true,3057305045419,3355.34,0.00,318347.17,Essential
681,23/02/2023,Automotive,true,3833268696704,332.47,0.00,318014.70,Important
682,23/02/2023,Kids,true,3465816865024,3409.26,0.00,314605.44,Essential
683,23/02/2023,Jewelry,false,3648139443075,0.00,2901.04,317506.48,Non-important
684,24/02/2023,Movies,true,3856547992924,611.12,0.00,316895.36,Non-Essential
685,24/02/2023,Home,true,3218343058276,4289.94,0.00,312605.42,Important
686,24/02/2023,Garden,true,3903016845152,4334.85,0.00,308270.57,Non-important
687,24/02/2023,Clothing,false,3685590013880,0.00,2084.14,310354.71,Non-important
688,24/02/2023,Baby,false,3152759593751,0.00,1322.55,311677.26,Essential
689,24/02/2023,Health,false,3860490397684,0.00,611.28,312288.54,Non-important
690,24/02/2023,Jewelry,false,3781932700681,0.00,998.30,313286.84,Non-important
691,25/02/2023,Home,false,3791159374177,0.00,2066.25,315353.09,Essential
692,25/02/2023,Toys,true,3070611122181,3115.97,0.00,312237.12,Essential
693,25/02/2023,Jewelry,true,3829032539975,1739.61,0.00,310497.51,Important
694,25/02/2023,Outdoors,true,3807906932512,4168.40,0.00,306329.11,Essential
695,25/02/2023,Jewelry,false,3584518104679,0.00,386.84,306715.95,Non-important
696,25/02/2023,Beauty,false,3176121379927,0.00,2806.60,309522.55,Non-Essential
697,25/02/2023,Tools,false,3762712262991,0.00,1244.85,310767.40,Important
698,25/02/2023,Health,true,3699209665633,3584.58,0.00,307182.82,Important
699,25/02/2023,Kids,false,3710818284804,0.00,811.12,307993.94,Essential
700,25/02/2023,Automotive,true,3120397905506,1534.90,0.00,306459.04,Essential
701,25/02/2023,Home,false,3236881843627,0.00,2800.30,309259.34,Non-Essential
702,25/02/2023,Industrial,true,3766509380682,3294.38,0.00,305964.96,Non-Essential
703,25/02/2023,Grocery,true,3053552579179,4363.22,0.00,301601.74,Important
704,25/02/2023,Outdoors,false,3172076513291,0.00,970.28,302572.02,Non-Essential
705,25/02/2023,Shoes,false,3958354778019,0.00,1537.88,304109.90,Non-Essential
706,25/02/2023,Outdoors,false,3360417585248,0.00,2384.83,306494.73,Essential
707,25/02/2023,Clothing,true,3341086888338,4542.90,0.00,301951.83,Non-Essential
708,25/02/2023,Games,true,3978146109543,897.86,0.00,301053.97,Important
709,25/02/2023,Sports,false,3790352258024,0.00,2875.36,303929.33,Essential
710,26/02/2023,Industrial,false,3033428108196,0.00,2566.84,306496.17,Essential
711,26/02/2023,Automotive,true,3310499263388,2915.88,0.00,303580.29,Important
712,26/02/2023,Clothing,true,3295443142687,4052.32,0.00,299527.97,Essential
713,26/02/2023,Garden,true,3449432490602,1903.16,0.00,297624.81,Non-important
714,26/02/2023,Outdoors,true,3377848437485,212.60,0.00,297412.21,Non-important
715,26/02/2023,Home,false,3325548417873,0.00,276.79,297689.00,Important
716,26/02/2023,Shoes,false,3672887032701,0.00,1895.92,299584.92,Non-important
717,26/02/2023,Sports,true,3058481157330,1782.11,0.00,297802.81,Essential
718,26/02/2023,Shoes,false,3049270925950,0.00,372.18,298174.99,Non-Essential
719,27/02/2023,Garden,false,3879818548104,0.00,2917.59,301092.58,Non-Essential
720,27/02/2023,Electronics,false,3983478901769,0.00,1006.83,302099.41,Non-important
721,27/02/2023,Industrial,false,3079277221713,0.00,1222.48,303321.89,Essential
722,27/02/2023,Kids,true,3148048366544,254.38,0.00,303067.51,Non-important
723,27/02/2023,Electronics,true,3539635214536,4584.37,0.00,298483.14,Important
724,27/02/2023,Jewelry,false,3561756416521,0.00,852.06,299335.20,Non-Essential
725,27/02/2023,Shoes,true,3974011479098,1343.45,0.00,297991.75,Essential
726,27/02/2023,Outdoors,true,3778040535884,2845.00,0.00,295146.75,Essential
727,28/02/2023,Tools,true,3961959467767,910.37,0.00,294236.38,Essential
728,28/02/2023,Movies,false,3741033600699,0.00,1769.80,296006.18,Important
729,28/02/2023,Toys,false,3383190526651,0.00,1922.97,297929.15,Non-important
730,28/02/2023,Automotive,true,3021455023542,4304.73,0.00,293624.42,Non-Essential
731,28/02/2023,Clothing,true,3772484755344,161.84,0.00,293462.58,Important
732,28/02/2023,Clothing,true,3033236152999,2945.76,0.00,290516.82,Non-important
733,28/02/2023,Baby,false,3505563419391,0.00,528.63,291045.45,Essential
734,28/02/2023,Industrial,false,3485567677254,0.00,440.44,291485.89,Non-important
735,28/02/2023,Music,true,3858245715508,3035.34,0.00,288450.55,Non-Essential
736,28/02/2023,Music,false,3789076915913,0.00,2156.12,290606.67,Non-important
737,28/02/2023,Home,false,3222143383344,0.00,1228.33,291835.00,Essential
738,01/03/2023,Electronics,false,3679864632801,0.00,864.90,292699.90,Essential
739,01/03/2023,Sports,false,3211901386274,0.00,1987.66,294687.56,Non-Essential
740,01/03/2023,Sports,false,3567778362764,0.00,1039.40,295726.96,Important
741,01/03/2023,Outdoors,true,3853442521525,4522.83,0.00,291204.13,Essential
742,01/03/2023,Electronics,false,3766499422001,0.00,1551.92,292756.05,Essential
743,01/03/2023,Toys,false,3147094482524,0.00,1310.75,294066.80,Non-important
744,01/03/2023,Electronics,true,3359530457554,2754.76,0.00,291312.04,Non-Essential
745,01/03/2023,Clothing,false,3602073932431,0.00,2435.59,293747.63,Essential
746,01/03/2023,Electronics,true,3841152699107,3852.99,0.00,289894.64,Non-important
747,01/03/2023,Computers,false,3116448384107,0.00,754.04,290648.68,Non-Essential
748,01/03/2023,Books,true,3884228255070,1591.88,0.00,289056.80,Non-important
749,01/03/2023,Movies,true,3162096354322,2145.59,0.00,286911.21,Non-important
750,01/03/2023,Home,false,3410305819437,0.00,762.58,287673.79,Non-important
751,01/03/2023,Games,false,3494988533831,0.00,1608.98,289282.77,Essential
752,01/03/2023,Shoes,false,3237284383711,0.00,1815.69,291098.46,Non-Essential
753,01/03/2023,Music,true,3941930172187,1193.93,0.00,289904.53,Non-important
754,01/03/2023,Outdoors,false,3685112756120,0.00,2258.31,292162.84,Non-important
755,01/03/2023,Computers,false,3599439816817,0.00,1585.90,293748.74,Essential
756,01/03/2023,Home,true,3878165134810,11.30,0.00,293737.44,Non-Essential
757,02/03/2023,Garden,true,3562105237092,4123.86,0.00,289613.58,Non-important
758,02/03/2023,Games,true,3567768069784,3486.13,0.00,286127.45,Important
759,02/03/2023,Books,true,3970956082592,4545.93,0.00,281581.52,Non-Essential
760,02/03/2023,Tools,false,3497235655679,0.00,779.86,282361.38,Non-Essential
761,02/03/2023,Health,true,3547488543115,3070.41,0.00,279290.97,Essential
762,02/03/2023,Tools,true,3968479731390,3477.57,0.00,275813.40,Non-important
763,02/03/2023,Toys,false,3786022983646,0.00,380.19,276193.59,Important
764,02/03/2023,Clothing,true,3403683101553,4998.87,0.00,271194.72,Essential
765,02/03/2023,Beauty,false,3443478601804,0.00,82.48,271277.20,Non-Essential
766,02/03/2023,Toys,false,3000845429553,0.00,925.27,272202.47,Essential
767,02/03/2023,Grocery,false,3955968485508,0.00,655.39,272857.86,Essential
768,02/03/2023,Garden,true,3960300787968,104.94,0.00,272752.92,Non-important
769,02/03/2023,Baby,false,3291910870604,0.00,2524.42,275277.34,Important
770,02/03/2023,Computers,true,3487491524071,4098.81,0.00,271178.53,Non-Essential
771,02/03/2023,Jewelry,true,3740048261446,2116.88,0.00,269061.65,Non-important
772,03/03/2023,Outdoors,false,3347049841352,0.00,139.21,269200.86,Non-Essential
773,03/03/2023,Jewelry,false,3565170068585,0.00,1151.81,270352.67,Non-important
774,03/03/2023,Kids,true,3320933637632,3800.71,0.00,266551.96,Essential
775,03/03/2023,Movies,false,3114420536103,0.00,966.97,267518.93,Important
776,03/03/2023,Grocery,false,3713203361135,0.00,2667.20,270186.13,Non-important
777,04/03/2023,Movies,false,3662786601089,0.00,994.86,271180.99,Non-Essential
778,04/03/2023,Beauty,true,3135363847969,3407.26,0.00,267773.73,Essential
779,04/03/2023,Baby,true,3825404345730,4483.03,0.00,263290.70,Non-Essential
780,04/03/2023,Sports,true,3666597906875,4724.15,0.00,258566.55,Important
781,04/03/2023,Garden,true,3734510472850,973.23,0.00,257593.32,Non-Essential
782,04/03/2023,Garden,true,3578419273953,2958.94,0.00,254634.38,Essential
783,04/03/2023,Automotive,false,3829095665792,0.00,1411.05,256045.43,Essential
784,04/03/2023,Jewelry,false,3644684611185,0.00,1382.99,257428.42,Essential
785,04/03/2023,Computers,true,3112686097967,1212.20,0.00,256216.22,Essential
786,04/03/2023,Baby,false,3620291919056,0.00,751.86,256968.08,Essential
787,04/03/2023,Movies,true,3779637154403,1923.02,0.00,255045.06,Important
788,04/03/2023,Baby,false,3315061397576,0.00,2121.36,257166.42,Important
789,05/03/2023,Baby,true,3192916161069,700.58,0.00,256465.84,Essential
790,05/03/2023,Clothing,false,3883649006335,0.00,2534.39,259000.23,Non-Essential
791,05/03/2023,Tools,false,3703236616471,0.00,1915.03,260915.26,Essential
792,05/03/2023,Games,true,3165430443191,3428.08,0.00,257487.18,Essential
793,05/03/2023,Garden,false,3394865854244,0.00,1823.09,259310.27,Essential
794,05/03/2023,Beauty,false,3439722750206,0.00,1667.64,260977.91,Non-Essential
795,05/03/2023,Kids,true,3959924733198,1995.56,0.00,258982.35,Essential
796,05/03/2023,Kids,false,3415637678660,0.00,455.13,259437.48,Non-Essential
797,05/03/2023,Electronics,true,3962890531503,519.58,0.00,258917.90,Important
798,05/03/2023,Sports,false,3870781277827,0.00,2635.03,261552.93,Essential
799,05/03/2023,Garden,false,3450974394521,0.00,2738.66,264291.59,Non-important
800,05/03/2023,Jewelry,true,3497526924819,307.05,0.00,263984.54,Important
801,06/03/2023,Clothing,false,3361544335106,0.00,2618.19,266602.73,Non-Essential
802,06/03/2023,Kids,true,3144322641724,1329.27,0.00,265273.46,Non-important
803,06/03/2023,Outdoors,false,3615449563323,0.00,630.47,265903.93,Essential
804,06/03/2023,Kids,true,3237831981293,1421.33,0.00,264482.60,Important
805,06/03/2023,Baby,false,3182607865345,0.00,1309.59,265792.19,Non-Essential
806,06/03/2023,Computers,false,3996850630089,0.00,1951.13,267743.32,Non-important
807,06/03/2023,Automotive,false,3680110587952,0.00,2230.68,269974.00,Important
808,06/03/2023,Books,true,3127528583549,37.38,0.00,269936.62,Non-Essential
809,06/03/2023,Jewelry,false,3804271092034,0.00,1763.24,271699.86,Non-important
810,06/03/2023,Music,true,3732208323678,403.30,0.00,271296.56,Non-Essential
811,06/03/2023,Movies,true,3173718411617,2492.84,0.00,268803.72,Essential
812,06/03/2023,Books,true,3941380895966,2421.70,0.00,266382.02,Important
813,06/03/2023,Movies,true,3067302213393,1046.20,0.00,265335.82,Essential
814,07/03/2023,Clothing,true,3981659027898,3519.42,0.00,261816.40,Essential
815,07/03/2023,Clothing,false,3164437984659,0.00,1739.94,263556.34,Essential
816,07/03/2023,Beauty,false,3774472361210,0.00,2135.69,265692.03,Important
817,07/03/2023,Electronics,true,3628274484146,472.07,0.00,265219.96,Important
818,07/03/2023,Baby,false,3166799049867,0.00,791.05,266011.01,Essential
819,07/03/2023,Automotive,true,3034979700260,14.34,0.00,265996.67,Essential
820,07/03/2023,Electronics,true,3400948356641,2625.51,0.00,263371.16,Non-important
821,08/03/2023,Jewelry,true,3792390034659,371.93,0.00,262999.23,Non-important
822,08/03/2023,Music,false,3854159533074,0.00,1537.40,264536.63,Important
823,08/03/2023,Movies,false,3729782890604,0.00,442.77,264979.40,Non-Essential
824,08/03/2023,Electronics,true,3866774443618,4257.32,0.00,260722.08,Essential
825,08/03/2023,Music,true,3822084481234,2607.95,0.00,258114.13,Important
826,08/03/2023,Movies,true,3553075680024,660.61,0.00,257453.52,Non-important
827,08/03/2023,Sports,true,3666386228473,4917.58,0.00,252535.94,Non-Essential
828,08/03/2023,Computers,true,3849772341702,3253.44,0.00,249282.50,Non-important
829,08/03/2023,Clothing,true,3939035326800,1486.63,0.00,247795.87,Non-Essential
830,08/03/2023,Home,true,3732718073388,251.72,0.00,247544.15,Non-important
831,08/03/2023,Jewelry,true,3039297968835,1330.75,0.00,246213.40,Important
832,08/03/2023,Clothing,true,3588290943273,1863.42,0.00,244349.98,Important
833,08/03/2023,Baby,true,3966050759879,898.79,0.00,243451.19,Important
834,09/03/2023,Books,true,3748242028494,2246.62,0.00,241204.57,Non-important
835,09/03/2023,Industrial,false,3635664867636,0.00,2521.25,243725.82,Non-important
836,09/03/2023,Sports,true,3126869884529,3348.11,0.00,240377.71,Non-important
837,09/03/2023,Kids,true,3533780634655,2939.42,0.00,237438.29,Non-important
838,09/03/2023,Movies,true,3263668866545,4967.46,0.00,232470.83,Important
839,09/03/2023,Music,false,3666723433394,0.00,507.66,232978.49,Non-important
840,09/03/2023,Automotive,true,3782257854237,4944.97,0.00,228033.52,Important
841,09/03/2023,Computers,false,3018907416014,0.00,2029.38,230062.90,Essential
842,09/03/2023,Sports,false,3703928364404,0.00,60.64,230123.54,Essential
843,09/03/2023,Sports,false,3288475780044,0.00,2296.44,232419.98,Non-Essential
844,09/03/2023,Health,false,3852052239425,0.00,852.45,233272.43,Essential
845,09/03/2023,Outdoors,true,3926755406984,3224.13,0.00,230048.30,Important
846,10/03/2023,Shoes,true,3482777402898,3681.59,0.00,226366.71,Non-Essential
847,10/03/2023,Outdoors,true,3895597441310,3302.07,0.00,223064.64,Non-Essential
848,10/03/2023,Clothing,true,3922147501597,3775.01,0.00,219289.63,Important
849,10/03/2023,Electronics,true,3194325137945,2641.89,0.00,216647.74,Non-important
850,10/03/2023,Books,false,3350865945856,0.00,2603.95,219251.69,Essential
851,10/03/2023,Kids,true,3531086726068,312.47,0.00,218939.22,Essential
852,10/03/2023,Industrial,true,3876134523059,4868.28,0.00,214070.94,Important
853,10/03/2023,Movies,false,3205170733737,0.00,1387.63,215458.57,Important
854,10/03/2023,Music,true,3095564736991,1510.02,0.00,213948.55,Important
855,10/03/2023,Garden,true,3432380578895,3676.69,0.00,210271.86,Non-important
856,10/03/2023,Outdoors,true,3902267519280,3984.62,0.00,206287.24,Essential
857,10/03/2023,Tools,true,3539469607217,4807.22,0.00,201480.02,Non-important
858,11/03/2023,Health,false,3603194593724,0.00,1213.77,202693.79,Essential
859,11/03/2023,Tools,false,3734790694237,0.00,2104.36,204798.15,Essential
860,11/03/2023,Toys,true,3875473612769,4710.22,0.00,200087.93,Important
861,11/03/2023,Computers,false,3731343401375,0.00,1410.25,201498.18,Important
862,11/03/2023,Computers,true,3830251037185,3146.39,0.00,198351.79,Non-Essential
863,11/03/2023,Baby,false,3714363416916,0.00,1581.27,199933.06,Non-important
864,11/03/2023,Toys,true,3642138346399,2265.05,0.00,197668.01,Non-Essential
865,11/03/2023,Home,false,3365971415584,0.00,553.86,198221.87,Essential
866,11/03/2023,Home,false,3859245582171,0.00,2752.66,200974.53,Non-Essential
867,11/03/2023,Outdoors,true,3310875456136,684.62,0.00,200289.91,Non-Essential
868,12/03/2023,Sports,false,3501086799694,0.00,771.43,201061.34,Non-important
869,12/03/2023,Sports,false,3116982859489,0.00,2904.31,203965.65,Essential
870,12/03/2023,Home,false,3854040110135,0.00,2919.91,206885.56,Non-important
871,12/03/2023,Outdoors,false,3283405691105,0.00,2717.15,209602.71,Non-Essential
872,12/03/2023,Jewelry,false,3467963732662,0.00,607.82,210210.53,Important
873,12/03/2023,Baby,true,3288926229399,4728.77,0.00,205481.76,Important
874,12/03/2023,Industrial,false,3346242485642,0.00,470.78,205952.54,Non-important
875,12/03/2023,Beauty,true,3361391961599,3547.03,0.00,202405.51,Important
876,12/03/2023,Tools,true,3866987284968,2554.27,0.00,199851.24,Important
877,12/03/2023,Sports,true,3708196075615,2824.77,0.00,197026.47,Non-Essential
878,12/03/2023,Movies,false,3290723455665,0.00,1344.49,198370.96,Non-Essential
879,12/03/2023,Games,false,3080182955133,0.00,1993.05,200364.01,Non-important
880,12/03/2023,Books,false,3495307169840,0.00,1625.22,201989.23,Non-important
881,12/03/2023,Home,false,3991397205811,0.00,1288.11,203277.34,Non-important
882,12/03/2023,Kids,false,3866182214967,0.00,2250.88,205528.22,Non-important
883,12/03/2023,Grocery,false,3081827805394,0.00,1184.91,206713.13,Essential
884,12/03/2023,Shoes,false,3479967073470,0.00,466.83,207179.96,Essential
885,13/03/2023,Baby,true,3359507752855,1798.11,0.00,205381.85,Important
886,13/03/2023,Garden,false,3103176517261,0.00,864.13,206245.98,Non-Essential
887,13/03/2023,Music,true,3596639804754,1325.23,0.00,204920.75,Essential
888,13/03/2023,Movies,false,3046919516936,0.00,1684.25,206605.00,Important
889,13/03/2023,Outdoors,false,3612857163341,0.00,1674.74,208279.74,Non-Essential
890,13/03/2023,Music,false,3321280517528,0.00,328.23,208607.97,Non-Essential
891,13/03/2023,Health,true,3012915069946,988.65,0.00,207619.32,Essential
892,13/03/2023,Music,false,3144770097020,0.00,1277.23,208896.55,Essential
893,13/03/2023,Jewelry,true,3766600020636,1398.74,0.00,207497.81,Non-Essential
894,13/03/2023,Toys,false,3696566651162,0.00,658.01,208155.82,Essential
895,14/03/2023,Computers,false,3283886174770,0.00,760.27,208916.09,Essential
896,14/03/2023,Outdoors,false,3434188854208,0.00,2174.26,211090.35,Non-Essential
897,14/03/2023,Garden,true,3913058548701,2119.28,0.00,208971.07,Important
898,14/03/2023,Beauty,false,3483839959410,0.00,1061.08,210032.15,Important
899,14/03/2023,Industrial,false,3015008277230,0.00,1607.74,211639.89,Non-important
900,14/03/2023,Movies,true,3359409396777,990.33,0.00,210649.56,Important
901,14/03/2023,Computers,false,3546239117425,0.00,2986.43,213635.99,Essential
902,14/03/2023,Beauty,false,3098547066332,0.00,453.30,214089.29,Essential
903,14/03/2023,Books,false,3209832214428,0.00,229.89,214319.18,Non-Essential
904,14/03/2023,Electronics,true,3215882021889,718.13,0.00,213601.05,Important
905,14/03/2023,Clothing,true,3258086561798,4731.24,0.00,208869.81,Non-Essential
906,14/03/2023,Garden,true,3947677176233,1630.87,0.00,207238.94,Important
907,15/03/2023,Games,false,3162607810364,0.00,850.26,208089.20,Non-Essential
908,15/03/2023,Computers,false,3884937239299,0.00,2029.45,210118.65,Important
909,15/03/2023,Beauty,false,3037972636194,0.00,1299.25,211417.90,Non-Essential
910,15/03/2023,Clothing,false,3007035703316,0.00,2118.93,213536.83,Essential
911,15/03/2023,Grocery,false,3786761384166,0.00,2234.58,215771.41,Non-Essential
912,15/03/2023,Electronics,false,3745050674806,0.00,2754.83,218526.24,Non-important
913,15/03/2023,Outdoors,true,3941544397424,3648.87,0.00,214877.37,Essential
914,15/03/2023,Industrial,true,3145883973205,35.35,0.00,214842.02,Non-Essential
915,15/03/2023,Outdoors,true,3539751217997,4920.22,0.00,209921.80,Essential
916,15/03/2023,Games,true,3402359438329,3273.28,0.00,206648.52,Non-important
917,15/03/2023,Movies,false,3238185323130,0.00,1792.82,208441.34,Important
918,15/03/2023,Jewelry,false,3716833980221,0.00,1060.20,209501.54,Non-important
919,15/03/2023,Baby,false,3882086389785,0.00,1266.02,210767.56,Non-Essential
920,15/03/2023,Beauty,true,3804308652905,3074.28,0.00,207693.28,Essential
921,15/03/2023,Movies,true,3894754244863,425.39,0.00,207267.89,Essential
922,16/03/2023,Music,false,3138356601637,0.00,2164.58,209432.47,Important
923,16/03/2023,Music,true,3123793910071,317.00,0.00,209115.47,Non-Essential
924,16/03/2023,Beauty,true,3439686725908,1240.80,0.00,207874.67,Important
925,16/03/2023,Computers,false,3097384775710,0.00,1208.57,209083.24,Non-Essential
926,16/03/2023,Shoes,true,3369505028196,511.83,0.00,208571.41,Non-Essential
927,16/03/2023,Clothing,false,3877339377527,0.00,1820.51,210391.92,Non-Essential
928,16/03/2023,Home,true,3972988360027,1778.94,0.00,208612.98,Non-important
929,16/03/2023,Garden,false,3378026058921,0.00,756.09,209369.07,Essential
930,16/03/2023,Movies,false,3877498255603,0.00,1083.67,210452.74,Non-important
931,16/03/2023,Garden,false,3430497796632,0.00,2541.40,212994.14,Essential
932,16/03/2023,Clothing,true,3290151222297,3254.83,0.00,209739.31,Non-important
933,16/03/2023,Beauty,false,3597742001397,0.00,678.64,210417.95,Non-important
934,16/03/2023,Clothing,false,3937564130816,0.00,114.21,210532.16,Essential
935,17/03/2023,Industrial,true,3690535152963,2469.57,0.00,208062.59,Important
936,17/03/2023,Toys,true,3161891839593,734.92,0.00,207327.67,Essential
937,17/03/2023,Shoes,false,3375682946527,0.00,2998.44,210326.11,Important
938,17/03/2023,Clothing,true,3162503215679,4600.40,0.00,205725.71,Non-important
939,17/03/2023,Automotive,false,3426469011652,0.00,1218.06,206943.77,Essential
940,17/03/2023,Sports,false,3962133753555,0.00,352.18,207295.95,Essential
941,17/03/2023,Computers,false,3271172629641,0.00,1293.10,208589.05,Important
942,17/03/2023,Grocery,true,3789520088789,2078.22,0.00,206510.83,Essential
943,17/03/2023,Industrial,true,3016184956424,1859.47,0.00,204651.36,Important
944,17/03/2023,Home,false,3347915119164,0.00,46.33,204697.69,Essential
945,17/03/2023,Grocery,false,3456216648231,0.00,517.13,205214.82,Essential
946,17/03/2023,Movies,true,3141616005740,3867.86,0.00,201346.96,Important
947,17/03/2023,Grocery,true,3698002659074,1789.02,0.00,199557.94,Non-Essential
948,18/03/2023,Tools,true,3382256405484,453.30,0.00,199104.64,Non-Essential
949,18/03/2023,Sports,true,3800811369251,4967.93,0.00,194136.71,Important
950,18/03/2023,Music,true,3518322389610,4939.17,0.00,189197.54,Non-important
951,18/03/2023,Sports,true,3933371239057,575.78,0.00,188621.76,Essential
952,18/03/2023,Garden,false,3929371034180,0.00,1259.42,189881.18,Non-Essential
953,18/03/2023,Baby,true,3692548797402,3418.94,0.00,186462.24,Non-Essential
954,18/03/2023,Industrial,false,3262805626516,0.00,2455.99,188918.23,Essential
955,18/03/2023,Grocery,false,3818146785456,0.00,186.02,189104.25,Essential
956,18/03/2023,Outdoors,true,3156919474740,2776.08,0.00,186328.17,Non-Essential
957,19/03/2023,Computers,true,3799846145397,4545.44,0.00,181782.73,Important
958,19/03/2023,Tools,true,3588198883443,3752.22,0.00,178030.51,Non-important
959,19/03/2023,Electronics,true,3799828363529,436.08,0.00,177594.43,Essential
960,19/03/2023,Movies,true,3463573982589,1827.58,0.00,175766.85,Important
961,19/03/2023,Music,true,3163855961560,599.33,0.00,175167.52,Important
962,19/03/2023,Industrial,false,3949895684013,0.00,352.88,175520.40,Non-important
963,19/03/2023,Beauty,true,3553508894703,1959.16,0.00,173561.24,Non-important
964,19/03/2023,Garden,true,3599639528149,3345.65,0.00,170215.59,Non-Essential
965,19/03/2023,Games,false,3097308327561,0.00,401.13,170616.72,Essential
966,19/03/2023,Shoes,false,3972315380576,0.00,1509.81,172126.53,Essential
967,20/03/2023,Automotive,true,3191907865640,919.98,0.00,171206.55,Important
968,20/03/2023,Garden,true,3769584057583,2542.09,0.00,168664.46,Essential
969,20/03/2023,Industrial,true,3035526354726,674.44,0.00,167990.02,Non-Essential
970,20/03/2023,Clothing,false,3741031029235,0.00,2817.02,170807.04,Essential
971,20/03/2023,Tools,true,3283996937853,3400.82,0.00,167406.22,Non-important
972,20/03/2023,Sports,false,3074135010145,0.00,782.28,168188.50,Essential
973,20/03/2023,Computers,true,3924385728588,4314.45,0.00,163874.05,Non-important
974,20/03/2023,Baby,false,3709590856815,0.00,681.18,164555.23,Important
975,20/03/2023,Movies,true,3814815195908,314.98,0.00,164240.25,Important
976,21/03/2023,Garden,true,3929780377864,3938.92,0.00,160301.33,Important
977,21/03/2023,Outdoors,true,3454684326322,80.02,0.00,160221.31,Important
978,21/03/2023,Jewelry,true,3668703632825,72.37,0.00,160148.94,Non-Essential
979,21/03/2023,Home,false,3989075622685,0.00,1359.77,161508.71,Non-Essential
980,21/03/2023,Shoes,false,3505154417995,0.00,936.07,162444.78,Important
981,21/03/2023,Baby,true,3549638164346,3019.36,0.00,159425.42,Non-important
982,21/03/2023,Beauty,false,3580645180027,0.00,1973.50,161398.92,Non-Essential
983,21/03/2023,Shoes,true,3766194337092,265.65,0.00,161133.27,Non-Essential
984,21/03/2023,Health,true,3696810935975,2228.92,0.00,158904.35,Non-Essential
985,21/03/2023,Jewelry,true,3710812376008,4826.19,0.00,154078.16,Important
986,21/03/2023,Automotive,false,3467732807010,0.00,2704.12,156782.28,Important
987,22/03/2023,Computers,false,3719122782165,0.00,691.80,157474.08,Non-Essential
988,22/03/2023,Sports,true,3421544600041,1741.96,0.00,155732.12,Essential
989,22/03/2023,Automotive,true,3548791280175,503.49,0.00,155228.63,Non-Essential
990,22/03/2023,Industrial,true,3417559917694,4215.69,0.00,151012.94,Non-important
991,22/03/2023,Outdoors,false,3398663527189,0.00,2885.52,153898.46,Non-important
992,22/03/2023,Toys,false,3869203488018,0.00,1862.16,155760.62,Important
993,22/03/2023,Computers,true,3040534236401,4132.40,0.00,151628.22,Essential
994,22/03/2023,Tools,true,3271612637800,3954.77,0.00,147673.45,Important
995,22/03/2023,Computers,false,3353225381794,0.00,2387.06,150060.51,Non-important
996,22/03/2023,Automotive,false,3939763908695,0.00,1543.38,151603.89,Essential
997,22/03/2023,Industrial,false,3531752310735,0.00,2712.97,154316.86,Non-Essential
998,22/03/2023,Beauty,true,3884303237766,4344.67,0.00,149972.19,Essential
999,22/03/2023,Health,true,3461989086280,1280.50,0.00,148691.69,Non-Essential
1000,22/03/2023,Outdoors,false,3454836974048,0.00,2969.34,151661.03,Non-important
