Unnamed: 0,row,Txn Date,Description,Transfer To/From,Ref No./Cheque No.,Debit,Credit,Balance,Class,User,Estimated Expense,Saving
0,1,25/12/2022,Home,True,1216711285639,4305.53,0.0,366736.4,Important,aastha,4305.53,0.0
1,2,25/12/2022,Movies,False,1628188928766,0.0,4931.1,371667.5,Non-important,aastha,0.0,0.0
2,3,25/12/2022,Tools,False,1845200544154,0.0,1068.89,372736.39,Essential,aastha,0.0,0.0
3,4,25/12/2022,Computers,True,1158881602293,3224.64,0.0,369511.75,Non-important,aastha,3063.41,161.23
4,5,25/12/2022,Baby,True,1155313314792,3929.41,0.0,365582.34,Non-Essential,aastha,3143.53,785.88
5,6,25/12/2022,Outdoors,True,1964064057056,4919.93,0.0,360662.41,Important,aastha,4919.93,0.0
6,7,25/12/2022,Shoes,True,1410165680332,2472.18,0.0,358190.23,Essential,aastha,2224.96,247.22
7,8,25/12/2022,Shoes,True,1787909248407,4627.36,0.0,353562.87,Non-Essential,aastha,3701.89,925.47
8,9,26/12/2022,Movies,True,1111178882578,4093.32,0.0,349469.55,Non-Essential,aastha,3274.66,818.66
9,10,26/12/2022,Jewelry,True,1901839865372,4615.39,0.0,344854.16,Important,aastha,4615.39,0.0
10,11,26/12/2022,Baby,False,1149849741213,0.0,4208.6,349062.76,Non-important,aastha,0.0,0.0
11,12,26/12/2022,Games,False,1061688235863,0.0,4710.66,353773.42,Important,aastha,0.0,0.0
12,13,26/12/2022,Electronics,False,1515784777170,0.0,3961.57,357734.99,Non-important,aastha,0.0,0.0
13,14,26/12/2022,Jewelry,True,1946307926887,4759.78,0.0,352975.21,Non-Essential,aastha,3807.82,951.96
14,15,26/12/2022,Home,False,1910853350499,0.0,4451.46,357426.67,Non-Essential,aastha,0.0,0.0
15,16,26/12/2022,Music,False,1761503465919,0.0,2606.75,360033.42,Important,aastha,0.0,0.0
16,17,26/12/2022,Computers,True,1427324837447,2328.02,0.0,357705.4,Non-Essential,aastha,1862.42,465.6
17,18,27/12/2022,Toys,True,1886038371412,2444.28,0.0,355261.12,Essential,aastha,2199.85,244.43
18,19,27/12/2022,Shoes,True,1271566407268,1713.71,0.0,353547.41,Non-important,aastha,1628.02,85.69
19,20,27/12/2022,Books,True,1530899363843,1166.56,0.0,352380.85,Important,aastha,1166.56,0.0
20,21,27/12/2022,Home,False,1945203778016,0.0,2347.74,354728.59,Non-important,aastha,0.0,0.0
21,22,27/12/2022,Books,True,1509229677958,1377.66,0.0,353350.93,Important,aastha,1377.66,0.0
22,23,27/12/2022,Automotive,False,1822776952425,0.0,1032.86,354383.79,Important,aastha,0.0,0.0
23,24,27/12/2022,Music,False,1333215835490,0.0,1741.08,356124.87,Non-important,aastha,0.0,0.0
24,25,27/12/2022,Sports,False,1600412225837,0.0,332.84,356457.71,Non-Essential,aastha,0.0,0.0
25,26,27/12/2022,Games,False,1393813692289,0.0,3913.05,360370.76,Non-Essential,aastha,0.0,0.0
26,27,27/12/2022,Movies,False,1901544986917,0.0,1644.06,362014.82,Important,aastha,0.0,0.0
27,28,27/12/2022,Garden,False,1083092453533,0.0,3136.6,365151.42,Non-Essential,aastha,0.0,0.0
28,29,27/12/2022,Beauty,True,1582489008714,2772.05,0.0,362379.37,Essential,aastha,2494.85,277.21
29,30,27/12/2022,Jewelry,True,1832928677427,3216.62,0.0,359162.75,Non-Essential,aastha,2573.3,643.32
30,31,28/12/2022,Grocery,False,1478722462634,0.0,747.41,359910.16,Non-Essential,aastha,0.0,0.0
31,32,28/12/2022,Beauty,False,1391887194180,0.0,2466.87,362377.03,Non-important,aastha,0.0,0.0
32,33,28/12/2022,Automotive,False,1358791895777,0.0,1215.04,363592.07,Important,aastha,0.0,0.0
33,34,28/12/2022,Music,False,1600186255376,0.0,3660.92,367252.99,Non-important,aastha,0.0,0.0
34,35,28/12/2022,Baby,False,1078274897799,0.0,4936.88,372189.87,Important,aastha,0.0,0.0
35,36,28/12/2022,Home,True,1214682968682,2340.85,0.0,369849.02,Non-important,aastha,2223.81,117.04
36,37,28/12/2022,Clothing,True,1891792734290,3290.69,0.0,366558.33,Non-important,aastha,3126.16,164.53
37,38,28/12/2022,Beauty,True,1886603388091,1198.19,0.0,365360.14,Non-important,aastha,1138.28,59.91
38,39,28/12/2022,Movies,True,1257463513404,4138.86,0.0,361221.28,Essential,aastha,3724.97,413.89
39,40,28/12/2022,Music,True,1134116591041,336.56,0.0,360884.72,Non-Essential,aastha,269.25,67.31
40,41,28/12/2022,Garden,True,1695327523713,3854.66,0.0,357030.06,Non-Essential,aastha,3083.73,770.93
41,42,28/12/2022,Computers,True,1440121417025,2815.28,0.0,354214.78,Non-important,aastha,2674.52,140.76
42,43,29/12/2022,Sports,True,1633489556058,3771.93,0.0,350442.85,Important,aastha,3771.93,0.0
43,44,29/12/2022,Baby,True,1018121992677,3848.96,0.0,346593.89,Non-Essential,aastha,3079.17,769.79
44,45,29/12/2022,Outdoors,True,1612232915050,2033.23,0.0,344560.66,Essential,aastha,1829.91,203.32
45,46,29/12/2022,Computers,True,1138054035843,3208.47,0.0,341352.19,Important,aastha,3208.47,0.0
46,47,29/12/2022,Industrial,True,1471112235020,2394.72,0.0,338957.47,Important,aastha,2394.72,0.0
47,48,29/12/2022,Grocery,True,1659662908707,2409.25,0.0,336548.22,Important,aastha,2409.25,0.0
48,49,29/12/2022,Automotive,True,1808385672309,3730.59,0.0,332817.63,Non-Essential,aastha,2984.47,746.12
49,50,29/12/2022,Kids,True,1759160954543,676.03,0.0,332141.6,Important,aastha,676.03,0.0
50,51,29/12/2022,Grocery,True,1228215694230,2335.23,0.0,329806.37,Important,aastha,2335.23,0.0
51,52,29/12/2022,Grocery,True,1032373825595,3005.96,0.0,326800.41,Important,aastha,3005.96,0.0
52,53,29/12/2022,Grocery,True,1227606813167,1019.34,0.0,325781.07,Important,aastha,1019.34,0.0
53,54,29/12/2022,Games,False,1657204363677,0.0,848.65,326629.72,Non-important,aastha,0.0,0.0
54,55,29/12/2022,Baby,False,1673351227407,0.0,3840.11,330469.83,Essential,aastha,0.0,0.0
55,56,30/12/2022,Movies,True,1238173367124,3214.33,0.0,327255.5,Non-Essential,aastha,2571.46,642.87
56,57,30/12/2022,Garden,True,1256708972104,2690.57,0.0,324564.93,Important,aastha,2690.57,0.0
57,58,30/12/2022,Kids,True,1637385288453,1821.74,0.0,322743.19,Non-important,aastha,1730.65,91.09
58,59,30/12/2022,Clothing,False,1271212694279,0.0,3437.77,326180.96,Non-Essential,aastha,0.0,0.0
59,60,30/12/2022,Books,True,1248519481700,2355.0,0.0,323825.96,Essential,aastha,2119.5,235.5
60,61,30/12/2022,Grocery,False,1183503730736,0.0,1145.35,324971.31,Non-Essential,aastha,0.0,0.0
61,62,30/12/2022,Automotive,False,1311726825901,0.0,3555.11,328526.42,Non-important,aastha,0.0,0.0
62,63,30/12/2022,Beauty,True,1566372447836,3620.33,0.0,324906.09,Important,aastha,3620.33,0.0
63,64,30/12/2022,Sports,False,1918880348648,0.0,2647.61,327553.7,Non-Essential,aastha,0.0,0.0
64,65,30/12/2022,Grocery,True,1503183792831,3574.59,0.0,323979.11,Non-important,aastha,3395.86,178.73
65,66,31/12/2022,Baby,False,1866577674451,0.0,1693.23,325672.34,Essential,aastha,0.0,0.0
66,67,31/12/2022,Movies,True,1169322313677,975.11,0.0,324697.23,Non-Essential,aastha,780.09,195.02
67,68,31/12/2022,Books,False,1827104923933,0.0,4898.27,329595.5,Essential,aastha,0.0,0.0
68,69,31/12/2022,Clothing,False,1632346197886,0.0,2996.52,332592.02,Non-important,aastha,0.0,0.0
69,70,31/12/2022,Electronics,True,1261259208539,4039.86,0.0,328552.16,Essential,aastha,3635.87,403.99
70,71,31/12/2022,Industrial,False,1149007243478,0.0,2599.15,331151.31,Essential,aastha,0.0,0.0
71,72,31/12/2022,Electronics,False,1447696653968,0.0,4597.82,335749.13,Non-important,aastha,0.0,0.0
72,73,31/12/2022,Electronics,False,1167397396882,0.0,4495.36,340244.49,Important,aastha,0.0,0.0
73,74,31/12/2022,Grocery,True,1718528834755,449.98,0.0,339794.51,Essential,aastha,404.98,45.0
74,75,31/12/2022,Health,True,1751025592804,4025.53,0.0,335768.98,Non-Essential,aastha,3220.42,805.11
75,76,31/12/2022,Outdoors,False,1540073735547,0.0,3865.86,339634.84,Non-Essential,aastha,0.0,0.0
76,77,31/12/2022,Grocery,False,1717262253415,0.0,2299.55,341934.39,Non-Essential,aastha,0.0,0.0
77,78,31/12/2022,Shoes,False,1714145035231,0.0,1546.42,343480.81,Non-important,aastha,0.0,0.0
78,79,31/12/2022,Industrial,True,1490360538691,4298.32,0.0,339182.49,Important,aastha,4298.32,0.0
79,80,31/12/2022,Electronics,True,1281807723542,4871.63,0.0,334310.86,Important,aastha,4871.63,0.0
80,81,01/01/2023,Automotive,True,1194306271601,1332.71,0.0,332978.15,Non-important,aastha,1266.07,66.64
81,82,01/01/2023,Electronics,False,1432859331639,0.0,773.22,333751.37,Important,aastha,0.0,0.0
82,83,01/01/2023,Music,False,1334708259188,0.0,4746.36,338497.73,Essential,aastha,0.0,0.0
83,84,01/01/2023,Jewelry,False,1656967103721,0.0,1274.81,339772.54,Non-important,aastha,0.0,0.0
84,85,01/01/2023,Grocery,False,1639851096426,0.0,211.35,339983.89,Non-important,aastha,0.0,0.0
85,86,01/01/2023,Baby,False,1231310021210,0.0,2323.77,342307.66,Important,aastha,0.0,0.0
86,87,01/01/2023,Music,True,1785500168291,4616.63,0.0,337691.03,Essential,aastha,4154.97,461.66
87,88,01/01/2023,Games,False,1213005717332,0.0,4759.59,342450.62,Non-important,aastha,0.0,0.0
88,89,01/01/2023,Shoes,True,1385830127297,2166.71,0.0,340283.91,Essential,aastha,1950.04,216.67
89,90,01/01/2023,Kids,False,1893065931744,0.0,4570.27,344854.18,Non-Essential,aastha,0.0,0.0
90,91,01/01/2023,Movies,False,1300086563511,0.0,4474.94,349329.12,Non-important,aastha,0.0,0.0
91,92,02/01/2023,Music,True,1288104832546,3382.48,0.0,345946.64,Important,aastha,3382.48,0.0
92,93,02/01/2023,Music,False,1673433409918,0.0,2521.66,348468.3,Essential,aastha,0.0,0.0
93,94,02/01/2023,Electronics,True,1663731648489,3860.92,0.0,344607.38,Non-Essential,aastha,3088.74,772.18
94,95,02/01/2023,Toys,True,1309323608707,2766.53,0.0,341840.85,Non-Essential,aastha,2213.22,553.31
95,96,02/01/2023,Outdoors,True,1654982258739,1964.92,0.0,339875.93,Essential,aastha,1768.43,196.49
96,97,02/01/2023,Electronics,True,1889988388729,880.57,0.0,338995.36,Essential,aastha,792.51,88.06
97,98,02/01/2023,Home,True,1439734087787,3398.96,0.0,335596.4,Non-Essential,aastha,2719.17,679.79
98,99,02/01/2023,Automotive,True,1484581392252,1650.74,0.0,333945.66,Important,aastha,1650.74,0.0
99,100,02/01/2023,Games,True,1453073220555,4053.93,0.0,329891.73,Non-important,aastha,3851.23,202.7
100,101,02/01/2023,Garden,False,1502745278152,0.0,3169.71,333061.44,Non-Essential,aastha,0.0,0.0
101,102,03/01/2023,Beauty,True,1364196271047,853.39,0.0,332208.05,Important,aastha,853.39,0.0
102,103,03/01/2023,Toys,True,1408161244833,2600.56,0.0,329607.49,Non-Essential,aastha,2080.45,520.11
103,104,03/01/2023,Automotive,True,1188522627376,1595.55,0.0,328011.94,Essential,aastha,1435.99,159.56
104,105,03/01/2023,Electronics,True,1188098393559,22.59,0.0,327989.35,Non-important,aastha,21.46,1.13
105,106,03/01/2023,Grocery,True,1379768534678,2448.91,0.0,325540.44,Non-important,aastha,2326.46,122.45
106,107,03/01/2023,Beauty,False,1230552873404,0.0,2029.44,327569.88,Non-important,aastha,0.0,0.0
107,108,03/01/2023,Toys,True,1846125166715,1411.61,0.0,326158.27,Important,aastha,1411.61,0.0
108,109,03/01/2023,Music,True,1631990741532,4998.89,0.0,321159.38,Non-important,aastha,4748.95,249.94
109,110,03/01/2023,Music,False,1461091295372,0.0,4762.03,325921.41,Non-Essential,aastha,0.0,0.0
110,111,03/01/2023,Baby,True,1040004469347,4591.68,0.0,321329.73,Essential,aastha,4132.51,459.17
111,112,03/01/2023,Games,False,1107189126534,0.0,591.84,321921.57,Essential,aastha,0.0,0.0
112,113,03/01/2023,Beauty,True,1386805672134,2422.08,0.0,319499.49,Essential,aastha,2179.87,242.21
113,114,04/01/2023,Kids,True,1668577407752,3646.98,0.0,315852.51,Essential,aastha,3282.28,364.7
114,115,04/01/2023,Shoes,False,1348658380106,0.0,1930.73,317783.24,Non-Essential,aastha,0.0,0.0
115,116,04/01/2023,Garden,False,1990893085882,0.0,196.45,317979.69,Non-Essential,aastha,0.0,0.0
116,117,04/01/2023,Industrial,True,1217474410385,387.95,0.0,317591.74,Essential,aastha,349.15,38.8
117,118,04/01/2023,Jewelry,True,1090914120470,2201.6,0.0,315390.14,Essential,aastha,1981.44,220.16
118,119,04/01/2023,Garden,False,1127774834594,0.0,1236.3,316626.44,Essential,aastha,0.0,0.0
119,120,04/01/2023,Shoes,True,1749182004580,1120.49,0.0,315505.95,Non-important,aastha,1064.47,56.02
120,121,04/01/2023,Garden,False,1084147676159,0.0,715.2,316221.15,Non-important,aastha,0.0,0.0
121,122,04/01/2023,Grocery,True,1713773539918,1606.3,0.0,314614.85,Essential,aastha,1445.67,160.63
122,123,04/01/2023,Sports,True,1927853784163,2532.17,0.0,312082.68,Essential,aastha,2278.95,253.22
123,124,04/01/2023,Industrial,True,1406688514780,3828.51,0.0,308254.17,Essential,aastha,3445.66,382.85
124,125,04/01/2023,Outdoors,False,1657197813833,0.0,1088.14,309342.31,Essential,aastha,0.0,0.0
125,126,05/01/2023,Clothing,True,1799631306396,679.44,0.0,308662.87,Non-important,aastha,645.47,33.97
126,127,05/01/2023,Grocery,False,1123204772104,0.0,4701.31,313364.18,Essential,aastha,0.0,0.0
127,128,05/01/2023,Home,False,1223070022979,0.0,1103.69,314467.87,Important,aastha,0.0,0.0
128,129,05/01/2023,Toys,True,1752184386779,770.89,0.0,313696.98,Non-important,aastha,732.35,38.54
129,130,05/01/2023,Outdoors,False,1452518574120,0.0,3827.6,317524.58,Non-important,aastha,0.0,0.0
130,131,05/01/2023,Home,False,1258136962179,0.0,4056.56,321581.14,Essential,aastha,0.0,0.0
131,132,05/01/2023,Kids,False,1910394744699,0.0,2673.23,324254.37,Essential,aastha,0.0,0.0
132,133,05/01/2023,Shoes,False,1594853780377,0.0,3966.8,328221.17,Non-important,aastha,0.0,0.0
133,134,05/01/2023,Movies,True,1995246108893,1421.48,0.0,326799.69,Non-important,aastha,1350.41,71.07
134,135,06/01/2023,Grocery,True,1902077168219,1234.36,0.0,325565.33,Important,aastha,1234.36,0.0
135,136,06/01/2023,Jewelry,False,1471391289645,0.0,2032.72,327598.05,Essential,aastha,0.0,0.0
136,137,06/01/2023,Industrial,False,1600335973308,0.0,1479.95,329078.0,Non-important,aastha,0.0,0.0
137,138,06/01/2023,Baby,False,1738976206203,0.0,2931.08,332009.08,Essential,aastha,0.0,0.0
138,139,06/01/2023,Home,True,1218815897928,4783.75,0.0,327225.33,Non-Essential,aastha,3827.0,956.75
139,140,06/01/2023,Electronics,True,1996677474732,611.17,0.0,326614.16,Non-Essential,aastha,488.94,122.23
140,141,06/01/2023,Health,False,1365835078015,0.0,19.39,326633.55,Non-important,aastha,0.0,0.0
141,142,06/01/2023,Grocery,True,1123590614780,90.89,0.0,326542.66,Non-Essential,aastha,72.71,18.18
142,143,06/01/2023,Baby,False,1850965991702,0.0,410.47,326953.13,Essential,aastha,0.0,0.0
143,144,06/01/2023,Home,True,1535970797490,2473.78,0.0,324479.35,Non-Essential,aastha,1979.02,494.76
144,145,06/01/2023,Outdoors,False,1142868459139,0.0,2095.13,326574.48,Essential,aastha,0.0,0.0
145,146,06/01/2023,Shoes,False,1314357367970,0.0,837.65,327412.13,Non-Essential,aastha,0.0,0.0
146,147,06/01/2023,Outdoors,False,1929328346058,0.0,153.27,327565.4,Essential,aastha,0.0,0.0
147,148,07/01/2023,Movies,False,1884898818261,0.0,141.09,327706.49,Essential,aastha,0.0,0.0
148,149,07/01/2023,Tools,False,1269797556286,0.0,3953.53,331660.02,Non-important,aastha,0.0,0.0
149,150,07/01/2023,Industrial,True,1914000998589,3614.44,0.0,328045.58,Essential,aastha,3253.0,361.44
150,151,07/01/2023,Health,False,1564492273898,0.0,3582.79,331628.37,Essential,aastha,0.0,0.0
151,152,07/01/2023,Automotive,False,1191933754213,0.0,4254.32,335882.69,Important,aastha,0.0,0.0
152,153,07/01/2023,Kids,True,1065083475677,2339.12,0.0,333543.57,Non-important,aastha,2222.16,116.96
153,154,07/01/2023,Music,False,1305045959734,0.0,539.76,334083.33,Essential,aastha,0.0,0.0
154,155,07/01/2023,Sports,False,1497626432427,0.0,3991.17,338074.5,Essential,aastha,0.0,0.0
155,156,07/01/2023,Automotive,False,1434735399158,0.0,4582.49,342656.99,Important,aastha,0.0,0.0
156,157,08/01/2023,Garden,False,1406827775679,0.0,2954.36,345611.35,Essential,aastha,0.0,0.0
157,158,08/01/2023,Outdoors,True,1184158518356,624.11,0.0,344987.24,Important,aastha,624.11,0.0
158,159,08/01/2023,Grocery,False,1668786032081,0.0,3792.1,348779.34,Non-Essential,aastha,0.0,0.0
159,160,08/01/2023,Health,True,1482036738178,3253.67,0.0,345525.67,Essential,aastha,2928.3,325.37
160,161,08/01/2023,Games,False,1177054627052,0.0,1706.41,347232.08,Important,aastha,0.0,0.0
161,162,08/01/2023,Jewelry,False,1397730295820,0.0,3135.43,350367.51,Essential,aastha,0.0,0.0
162,163,09/01/2023,Garden,True,1314815020337,3329.69,0.0,347037.82,Non-Essential,aastha,2663.75,665.94
163,164,09/01/2023,Electronics,False,1819924622714,0.0,2426.53,349464.35,Non-important,aastha,0.0,0.0
164,165,09/01/2023,Grocery,True,1775131737415,4699.32,0.0,344765.03,Essential,aastha,4229.39,469.93
165,166,09/01/2023,Games,True,1952671516579,4021.45,0.0,340743.58,Essential,aastha,3619.3,402.14
166,167,09/01/2023,Sports,False,1685125935239,0.0,2299.69,343043.27,Important,aastha,0.0,0.0
167,168,09/01/2023,Automotive,False,1366004575601,0.0,3275.35,346318.62,Essential,aastha,0.0,0.0
168,169,09/01/2023,Toys,True,1265545087584,3177.42,0.0,343141.2,Non-important,aastha,3018.55,158.87
169,170,09/01/2023,Computers,False,1462967422083,0.0,2877.54,346018.74,Essential,aastha,0.0,0.0
170,171,09/01/2023,Baby,True,1192573332818,2736.1,0.0,343282.64,Non-important,aastha,2599.3,136.81
171,172,09/01/2023,Electronics,True,1639373940174,563.52,0.0,342719.12,Non-important,aastha,535.34,28.18
172,173,09/01/2023,Sports,False,1971375090135,0.0,1713.47,344432.59,Important,aastha,0.0,0.0
173,174,09/01/2023,Computers,True,1717324534984,3827.02,0.0,340605.57,Essential,aastha,3444.32,382.7
174,175,09/01/2023,Music,False,1001645990067,0.0,2032.19,342637.76,Non-important,aastha,0.0,0.0
175,176,10/01/2023,Garden,False,1337366768933,0.0,3692.23,346329.99,Important,aastha,0.0,0.0
176,177,10/01/2023,Books,False,1192542952887,0.0,734.21,347064.2,Non-Essential,aastha,0.0,0.0
177,178,10/01/2023,Toys,False,1224018720964,0.0,590.22,347654.42,Essential,aastha,0.0,0.0
178,179,10/01/2023,Books,False,1278497770308,0.0,3258.3,350912.72,Important,aastha,0.0,0.0
179,180,10/01/2023,Grocery,False,1838617278290,0.0,853.35,351766.07,Important,aastha,0.0,0.0
180,181,10/01/2023,Grocery,False,1942998045455,0.0,1704.08,353470.15,Important,aastha,0.0,0.0
181,182,10/01/2023,Beauty,True,1764149672126,607.19,0.0,352862.96,Essential,aastha,546.47,60.72
182,183,10/01/2023,Music,False,1112594127301,0.0,2714.28,355577.24,Non-Essential,aastha,0.0,0.0
183,184,10/01/2023,Books,True,1160441397734,3484.07,0.0,352093.17,Non-important,aastha,3309.87,174.2
184,185,11/01/2023,Home,False,1011574406343,0.0,4612.63,356705.8,Important,aastha,0.0,0.0
185,186,11/01/2023,Jewelry,False,1991361959174,0.0,4509.93,361215.73,Essential,aastha,0.0,0.0
186,187,11/01/2023,Games,True,1583016388303,3332.85,0.0,357882.88,Important,aastha,3332.85,0.0
187,188,11/01/2023,Jewelry,True,1347535727722,4049.79,0.0,353833.09,Non-important,aastha,3847.3,202.49
188,189,11/01/2023,Games,False,1721872397417,0.0,2889.96,356723.05,Essential,aastha,0.0,0.0
189,190,11/01/2023,Kids,False,1219430220388,0.0,3262.0,359985.05,Non-important,aastha,0.0,0.0
190,191,11/01/2023,Electronics,True,1204072064962,2481.39,0.0,357503.66,Essential,aastha,2233.25,248.14
191,192,11/01/2023,Industrial,True,1767786359392,277.96,0.0,357225.7,Non-important,aastha,264.06,13.9
192,193,11/01/2023,Automotive,False,1616111156003,0.0,1365.71,358591.41,Essential,aastha,0.0,0.0
193,194,12/01/2023,Kids,False,1447849502935,0.0,4200.43,362791.84,Non-Essential,aastha,0.0,0.0
194,195,12/01/2023,Kids,True,1558605550015,3439.86,0.0,359351.98,Important,aastha,3439.86,0.0
195,196,12/01/2023,Tools,True,1359283461601,4066.16,0.0,355285.82,Non-Essential,aastha,3252.93,813.23
196,197,12/01/2023,Automotive,True,1733415742999,710.2,0.0,354575.62,Important,aastha,710.2,0.0
197,198,12/01/2023,Sports,False,1576023049506,0.0,1801.53,356377.15,Essential,aastha,0.0,0.0
198,199,12/01/2023,Garden,False,1195231250431,0.0,2382.37,358759.52,Non-Essential,aastha,0.0,0.0
199,200,12/01/2023,Movies,False,1615467684998,0.0,2084.04,360843.56,Essential,aastha,0.0,0.0
200,201,12/01/2023,Jewelry,False,1709585006275,0.0,1673.16,362516.72,Non-important,aastha,0.0,0.0
201,202,12/01/2023,Clothing,True,1357153637664,4142.13,0.0,358374.59,Non-important,aastha,3935.02,207.11
202,203,12/01/2023,Home,True,1303227510075,2578.23,0.0,355796.36,Non-Essential,aastha,2062.58,515.65
203,204,12/01/2023,Clothing,False,1145215259523,0.0,160.02,355956.38,Non-Essential,aastha,0.0,0.0
204,205,12/01/2023,Beauty,False,1260780324432,0.0,4247.95,360204.33,Essential,aastha,0.0,0.0
205,206,12/01/2023,Clothing,True,1362785401175,2484.31,0.0,357720.02,Non-important,aastha,2360.09,124.22
206,207,12/01/2023,Movies,False,1206410758754,0.0,3283.55,361003.57,Important,aastha,0.0,0.0
207,208,12/01/2023,Beauty,True,1139799221234,2826.56,0.0,358177.01,Non-Essential,aastha,2261.25,565.31
208,209,13/01/2023,Outdoors,True,1867169154752,1730.09,0.0,356446.92,Non-Essential,aastha,1384.07,346.02
209,210,13/01/2023,Music,True,1273452936680,4084.41,0.0,352362.51,Non-important,aastha,3880.19,204.22
210,211,13/01/2023,Music,True,1777503558025,3399.91,0.0,348962.6,Non-important,aastha,3229.91,170.0
211,212,13/01/2023,Jewelry,True,1548355649535,3581.89,0.0,345380.71,Important,aastha,3581.89,0.0
212,213,13/01/2023,Grocery,True,1847160701218,4745.86,0.0,340634.85,Important,aastha,4745.86,0.0
213,214,13/01/2023,Health,True,1872443446310,3858.69,0.0,336776.16,Important,aastha,3858.69,0.0
214,215,13/01/2023,Music,True,1324110388095,3866.08,0.0,332910.08,Non-Essential,aastha,3092.86,773.22
215,216,13/01/2023,Books,False,1481505816151,0.0,1116.96,334027.04,Non-important,aastha,0.0,0.0
216,217,14/01/2023,Kids,False,1847979675869,0.0,2218.32,336245.36,Essential,aastha,0.0,0.0
217,218,14/01/2023,Music,True,1632316899083,2118.53,0.0,334126.83,Non-Essential,aastha,1694.82,423.71
218,219,14/01/2023,Computers,False,1014102143087,0.0,1139.88,335266.71,Non-Essential,aastha,0.0,0.0
219,220,14/01/2023,Tools,False,1259410158745,0.0,58.06,335324.77,Non-important,aastha,0.0,0.0
220,221,14/01/2023,Music,True,1309473372977,3158.69,0.0,332166.08,Essential,aastha,2842.82,315.87
221,222,14/01/2023,Home,True,1000274269107,2064.25,0.0,330101.83,Essential,aastha,1857.83,206.43
222,223,14/01/2023,Kids,False,1915419889322,0.0,2631.85,332733.68,Important,aastha,0.0,0.0
223,224,14/01/2023,Home,True,1374458583973,2491.94,0.0,330241.74,Non-important,aastha,2367.34,124.6
224,225,14/01/2023,Clothing,False,1936558227236,0.0,1217.81,331459.55,Non-Essential,aastha,0.0,0.0
225,226,14/01/2023,Books,True,1341932636564,1874.4,0.0,329585.15,Important,aastha,1874.4,0.0
226,227,14/01/2023,Books,False,1020991172147,0.0,3050.68,332635.83,Essential,aastha,0.0,0.0
227,228,15/01/2023,Games,False,1645171773836,0.0,2007.16,334642.99,Non-Essential,aastha,0.0,0.0
228,229,15/01/2023,Grocery,True,1550714076298,2303.87,0.0,332339.12,Essential,aastha,2073.48,230.39
229,230,15/01/2023,Grocery,True,1458125065890,2582.15,0.0,329756.97,Essential,aastha,2323.93,258.22
230,231,15/01/2023,Beauty,False,1037758770585,0.0,4020.34,333777.31,Non-important,aastha,0.0,0.0
231,232,15/01/2023,Shoes,True,1033937403545,2576.81,0.0,331200.5,Essential,aastha,2319.13,257.68
232,233,15/01/2023,Clothing,True,1786520795248,4078.7,0.0,327121.8,Non-important,aastha,3874.76,203.94
233,234,15/01/2023,Music,True,1684594253225,930.25,0.0,326191.55,Non-important,aastha,883.74,46.51
234,235,15/01/2023,Sports,False,1663555795041,0.0,1196.9,327388.45,Essential,aastha,0.0,0.0
235,236,15/01/2023,Garden,False,1092530794446,0.0,4834.56,332223.01,Important,aastha,0.0,0.0
236,237,15/01/2023,Toys,True,1025262480212,2842.06,0.0,329380.95,Non-important,aastha,2699.96,142.1
237,238,15/01/2023,Garden,False,1764570428314,0.0,1380.03,330760.98,Non-Essential,aastha,0.0,0.0
238,239,15/01/2023,Industrial,True,1266278152102,4208.2,0.0,326552.78,Essential,aastha,3787.38,420.82
239,240,15/01/2023,Computers,True,1831545171491,3389.88,0.0,323162.9,Essential,aastha,3050.89,338.99
240,241,15/01/2023,Baby,False,1945822666351,0.0,2871.09,326033.99,Essential,aastha,0.0,0.0
241,242,15/01/2023,Outdoors,False,1818055062543,0.0,3913.51,329947.5,Non-Essential,aastha,0.0,0.0
242,243,15/01/2023,Jewelry,False,1271594208064,0.0,3926.57,333874.07,Important,aastha,0.0,0.0
243,244,15/01/2023,Music,True,1957760818465,2298.3,0.0,331575.77,Important,aastha,2298.3,0.0
244,245,16/01/2023,Home,False,1515347891402,0.0,2323.36,333899.13,Non-Essential,aastha,0.0,0.0
245,246,16/01/2023,Kids,True,1555924032682,3352.71,0.0,330546.42,Non-important,aastha,3185.07,167.64
246,247,16/01/2023,Tools,False,1379100098007,0.0,635.11,331181.53,Non-important,aastha,0.0,0.0
247,248,16/01/2023,Shoes,True,1868281539037,2738.73,0.0,328442.8,Non-important,aastha,2601.79,136.94
248,249,16/01/2023,Books,False,1380859857120,0.0,4050.01,332492.81,Non-important,aastha,0.0,0.0
249,250,16/01/2023,Sports,False,1078223307129,0.0,4300.74,336793.55,Non-Essential,aastha,0.0,0.0
250,251,16/01/2023,Shoes,True,1433903914585,568.58,0.0,336224.97,Non-Essential,aastha,454.86,113.72
251,252,16/01/2023,Kids,False,1619828251337,0.0,2365.32,338590.29,Non-Essential,aastha,0.0,0.0
252,253,16/01/2023,Toys,False,1165240058266,0.0,1495.64,340085.93,Non-Essential,aastha,0.0,0.0
253,254,16/01/2023,Automotive,False,1397427896840,0.0,2484.95,342570.88,Essential,aastha,0.0,0.0
254,255,16/01/2023,Shoes,True,1386277208603,4219.18,0.0,338351.7,Non-Essential,aastha,3375.34,843.84
255,256,17/01/2023,Sports,False,1828074320652,0.0,3307.42,341659.12,Non-Essential,aastha,0.0,0.0
256,257,17/01/2023,Baby,True,1457384834969,1780.27,0.0,339878.85,Important,aastha,1780.27,0.0
257,258,17/01/2023,Beauty,True,1033892508286,86.48,0.0,339792.37,Non-Essential,aastha,69.18,17.3
258,259,17/01/2023,Beauty,False,1602327703897,0.0,181.29,339973.66,Essential,aastha,0.0,0.0
259,260,17/01/2023,Industrial,False,1243413441977,0.0,3427.28,343400.94,Essential,aastha,0.0,0.0
260,261,17/01/2023,Baby,False,1284000884113,0.0,1069.86,344470.8,Non-Essential,aastha,0.0,0.0
261,262,18/01/2023,Sports,True,1033115282812,2429.03,0.0,342041.77,Important,aastha,2429.03,0.0
262,263,18/01/2023,Health,False,1475990694012,0.0,429.9,342471.67,Essential,aastha,0.0,0.0
263,264,18/01/2023,Outdoors,True,1778090182344,1750.04,0.0,340721.63,Non-important,aastha,1662.54,87.5
264,265,18/01/2023,Grocery,False,1425972873088,0.0,1754.43,342476.06,Essential,aastha,0.0,0.0
265,266,18/01/2023,Books,False,1703284161515,0.0,1109.97,343586.03,Essential,aastha,0.0,0.0
266,267,18/01/2023,Baby,True,1660057184721,2533.97,0.0,341052.06,Important,aastha,2533.97,0.0
267,268,18/01/2023,Health,True,1326367069633,1164.52,0.0,339887.54,Essential,aastha,1048.07,116.45
268,269,18/01/2023,Sports,True,1858823953853,4033.8,0.0,335853.74,Non-important,aastha,3832.11,201.69
269,270,18/01/2023,Outdoors,True,1510673238894,2705.76,0.0,333147.98,Important,aastha,2705.76,0.0
270,271,18/01/2023,Jewelry,False,1719868556157,0.0,1420.13,334568.11,Non-Essential,aastha,0.0,0.0
271,272,18/01/2023,Toys,True,1880779075052,712.38,0.0,333855.73,Non-Essential,aastha,569.9,142.48
272,273,19/01/2023,Books,True,1942826636102,4846.13,0.0,329009.6,Non-important,aastha,4603.82,242.31
273,274,19/01/2023,Grocery,False,1315539734331,0.0,1806.93,330816.53,Essential,aastha,0.0,0.0
274,275,19/01/2023,Clothing,False,1943340331860,0.0,4585.96,335402.49,Essential,aastha,0.0,0.0
275,276,19/01/2023,Sports,False,1965765644166,0.0,3132.37,338534.86,Important,aastha,0.0,0.0
276,277,19/01/2023,Electronics,False,1909840236305,0.0,2806.37,341341.23,Non-important,aastha,0.0,0.0
277,278,19/01/2023,Shoes,False,1222464190899,0.0,4916.12,346257.35,Non-Essential,aastha,0.0,0.0
278,279,19/01/2023,Sports,True,1106747320098,714.23,0.0,345543.12,Non-important,aastha,678.52,35.71
279,280,19/01/2023,Movies,False,1790741085799,0.0,3872.87,349415.99,Important,aastha,0.0,0.0
280,281,19/01/2023,Kids,True,1032101188201,2988.96,0.0,346427.03,Important,aastha,2988.96,0.0
281,282,19/01/2023,Automotive,False,1197443730665,0.0,2458.61,348885.64,Important,aastha,0.0,0.0
282,283,19/01/2023,Clothing,True,1518267799054,2960.08,0.0,345925.56,Non-Essential,aastha,2368.06,592.02
283,284,19/01/2023,Shoes,False,1488222571674,0.0,4309.55,350235.11,Non-important,aastha,0.0,0.0
284,285,19/01/2023,Toys,False,1555700725882,0.0,1963.84,352198.95,Non-important,aastha,0.0,0.0
285,286,19/01/2023,Garden,False,1905534340032,0.0,1083.06,353282.01,Non-important,aastha,0.0,0.0
286,287,19/01/2023,Home,True,1539516176771,658.32,0.0,352623.69,Important,aastha,658.32,0.0
287,288,19/01/2023,Outdoors,False,1069897487236,0.0,634.91,353258.6,Essential,aastha,0.0,0.0
288,289,19/01/2023,Baby,True,1316251645690,1854.84,0.0,351403.76,Important,aastha,1854.84,0.0
289,290,20/01/2023,Automotive,False,1853604137466,0.0,2939.64,354343.4,Important,aastha,0.0,0.0
290,291,20/01/2023,Industrial,False,1150205534621,0.0,450.87,354794.27,Important,aastha,0.0,0.0
291,292,20/01/2023,Industrial,False,1386517771734,0.0,967.76,355762.03,Important,aastha,0.0,0.0
292,293,20/01/2023,Electronics,False,1698447777985,0.0,3651.0,359413.03,Essential,aastha,0.0,0.0
293,294,20/01/2023,Books,True,1309973044593,2909.11,0.0,356503.92,Non-Essential,aastha,2327.29,581.82
294,295,20/01/2023,Books,False,1067058297888,0.0,4869.22,361373.14,Non-Essential,aastha,0.0,0.0
295,296,20/01/2023,Home,False,1046921388555,0.0,4856.75,366229.89,Non-important,aastha,0.0,0.0
296,297,20/01/2023,Sports,False,1940903147809,0.0,2172.29,368402.18,Non-Essential,aastha,0.0,0.0
297,298,20/01/2023,Outdoors,False,1144485055172,0.0,2750.02,371152.2,Essential,aastha,0.0,0.0
298,299,20/01/2023,Garden,True,1123241762129,409.58,0.0,370742.62,Important,aastha,409.58,0.0
299,300,20/01/2023,Jewelry,False,1680321354354,0.0,681.23,371423.85,Essential,aastha,0.0,0.0
300,301,20/01/2023,Books,False,1796175089622,0.0,2195.95,373619.8,Non-important,aastha,0.0,0.0
301,302,20/01/2023,Movies,False,1411177213349,0.0,4131.58,377751.38,Important,aastha,0.0,0.0
302,303,20/01/2023,Kids,False,1958660834450,0.0,4191.46,381942.84,Important,aastha,0.0,0.0
303,304,21/01/2023,Clothing,False,1828176468644,0.0,1462.49,383405.33,Essential,aastha,0.0,0.0
304,305,21/01/2023,Home,True,1681852452382,4520.34,0.0,378884.99,Important,aastha,4520.34,0.0
305,306,21/01/2023,Tools,True,1759371353264,1868.03,0.0,377016.96,Essential,aastha,1681.23,186.8
306,307,21/01/2023,Grocery,True,1699030490410,1904.62,0.0,375112.34,Essential,aastha,1714.16,190.46
307,308,21/01/2023,Kids,False,1378808153335,0.0,1992.5,377104.84,Important,aastha,0.0,0.0
308,309,21/01/2023,Electronics,False,1088079142551,0.0,4102.7,381207.54,Non-important,aastha,0.0,0.0
309,310,21/01/2023,Garden,False,1720926083712,0.0,1337.16,382544.7,Essential,aastha,0.0,0.0
310,311,21/01/2023,Electronics,True,1514575106129,617.21,0.0,381927.49,Essential,aastha,555.49,61.72
311,312,21/01/2023,Games,False,1279198939587,0.0,3984.41,385911.9,Non-important,aastha,0.0,0.0
312,313,21/01/2023,Games,True,1594985599456,3326.57,0.0,382585.33,Essential,aastha,2993.91,332.66
313,314,21/01/2023,Grocery,False,1062026128575,0.0,1096.72,383682.05,Non-Essential,aastha,0.0,0.0
314,315,21/01/2023,Kids,True,1533205971272,870.76,0.0,382811.29,Essential,aastha,783.68,87.08
315,316,21/01/2023,Automotive,True,1920244779256,217.86,0.0,382593.43,Non-Essential,aastha,174.29,43.57
316,317,21/01/2023,Grocery,False,1901803379401,0.0,2130.93,384724.36,Important,aastha,0.0,0.0
317,318,21/01/2023,Kids,True,1564906507582,1916.48,0.0,382807.88,Important,aastha,1916.48,0.0
318,319,22/01/2023,Industrial,False,1053765430167,0.0,3599.76,386407.64,Essential,aastha,0.0,0.0
319,320,22/01/2023,Automotive,False,1374243917996,0.0,194.45,386602.09,Non-Essential,aastha,0.0,0.0
320,321,22/01/2023,Beauty,True,1657980096139,918.24,0.0,385683.85,Non-important,aastha,872.33,45.91
321,322,22/01/2023,Electronics,False,1120559723883,0.0,593.54,386277.39,Non-Essential,aastha,0.0,0.0
322,323,22/01/2023,Music,True,1729180591412,718.64,0.0,385558.75,Non-important,aastha,682.71,35.93
323,324,22/01/2023,Movies,True,1988746605565,2756.79,0.0,382801.96,Important,aastha,2756.79,0.0
324,325,23/01/2023,Garden,False,1681675570494,0.0,2040.98,384842.94,Non-Essential,aastha,0.0,0.0
325,326,23/01/2023,Home,True,1540450223331,4172.11,0.0,380670.83,Non-Essential,aastha,3337.69,834.42
326,327,23/01/2023,Beauty,False,1040384774506,0.0,3842.77,384513.6,Non-Essential,aastha,0.0,0.0
327,328,23/01/2023,Beauty,True,1444130184975,149.86,0.0,384363.74,Non-important,aastha,142.37,7.49
328,329,23/01/2023,Industrial,True,1486938034431,4195.2,0.0,380168.54,Essential,aastha,3775.68,419.52
329,330,23/01/2023,Industrial,True,1224258698493,824.98,0.0,379343.56,Non-important,aastha,783.73,41.25
330,331,23/01/2023,Electronics,True,1196216076117,3953.14,0.0,375390.42,Essential,aastha,3557.83,395.31
331,332,23/01/2023,Electronics,False,1556711873917,0.0,181.34,375571.76,Important,aastha,0.0,0.0
332,333,23/01/2023,Games,False,1476846730190,0.0,3047.03,378618.79,Non-Essential,aastha,0.0,0.0
333,334,23/01/2023,Garden,True,1197333932736,363.31,0.0,378255.48,Non-Essential,aastha,290.65,72.66
334,335,24/01/2023,Games,True,1440996580111,323.8,0.0,377931.68,Non-Essential,aastha,259.04,64.76
335,336,24/01/2023,Industrial,False,1006213154424,0.0,3419.95,381351.63,Important,aastha,0.0,0.0
336,337,24/01/2023,Music,True,1030260921847,4039.24,0.0,377312.39,Important,aastha,4039.24,0.0
337,338,24/01/2023,Automotive,True,1211635575102,2799.69,0.0,374512.7,Non-Essential,aastha,2239.75,559.94
338,339,24/01/2023,Health,False,1002337599253,0.0,4261.36,378774.06,Non-important,aastha,0.0,0.0
339,340,24/01/2023,Automotive,False,1943605285752,0.0,4275.57,383049.63,Essential,aastha,0.0,0.0
340,341,24/01/2023,Movies,True,1977843416841,1568.5,0.0,381481.13,Essential,aastha,1411.65,156.85
341,342,24/01/2023,Industrial,False,1037947344001,0.0,2159.83,383640.96,Non-Essential,aastha,0.0,0.0
342,343,25/01/2023,Outdoors,True,1773068253960,3023.28,0.0,380617.68,Non-Essential,aastha,2418.62,604.66
343,344,25/01/2023,Movies,False,1355360666931,0.0,3601.91,384219.59,Non-Essential,aastha,0.0,0.0
344,345,25/01/2023,Tools,False,1419850681921,0.0,1476.11,385695.7,Non-important,aastha,0.0,0.0
345,346,25/01/2023,Health,True,1536499700152,1255.39,0.0,384440.31,Non-important,aastha,1192.62,62.77
346,347,25/01/2023,Grocery,True,1981677439490,2990.73,0.0,381449.58,Non-Essential,aastha,2392.58,598.15
347,348,25/01/2023,Kids,False,1013631188645,0.0,518.23,381967.81,Non-Essential,aastha,0.0,0.0
348,349,25/01/2023,Garden,True,1872912072826,3855.42,0.0,378112.39,Essential,aastha,3469.88,385.54
349,350,25/01/2023,Outdoors,False,1586152078931,0.0,205.07,378317.46,Important,aastha,0.0,0.0
350,351,25/01/2023,Automotive,True,1165685259547,4100.95,0.0,374216.51,Essential,aastha,3690.85,410.1
351,352,25/01/2023,Outdoors,False,1452478821138,0.0,2699.02,376915.53,Non-Essential,aastha,0.0,0.0
352,353,25/01/2023,Beauty,True,1442494507807,1955.21,0.0,374960.32,Important,aastha,1955.21,0.0
353,354,25/01/2023,Outdoors,False,1187252267109,0.0,455.8,375416.12,Essential,aastha,0.0,0.0
354,355,26/01/2023,Clothing,False,1839886109520,0.0,645.59,376061.71,Non-important,aastha,0.0,0.0
355,356,26/01/2023,Baby,False,1310534954379,0.0,3985.59,380047.3,Non-Essential,aastha,0.0,0.0
356,357,26/01/2023,Grocery,True,1188345870396,3474.1,0.0,376573.2,Non-Essential,aastha,2779.28,694.82
357,358,26/01/2023,Automotive,False,1229728543378,0.0,2111.78,378684.98,Important,aastha,0.0,0.0
358,359,26/01/2023,Jewelry,True,1923903996531,1184.11,0.0,377500.87,Important,aastha,1184.11,0.0
359,360,26/01/2023,Health,True,1769276565463,563.28,0.0,376937.59,Non-Essential,aastha,450.62,112.66
360,361,26/01/2023,Industrial,False,1962023241217,0.0,2889.53,379827.12,Essential,aastha,0.0,0.0
361,362,26/01/2023,Shoes,False,1771097175371,0.0,4810.45,384637.57,Non-Essential,aastha,0.0,0.0
362,363,26/01/2023,Garden,False,1217650517798,0.0,4255.31,388892.88,Important,aastha,0.0,0.0
363,364,26/01/2023,Tools,False,1427375404369,0.0,161.08,389053.96,Essential,aastha,0.0,0.0
364,365,26/01/2023,Electronics,True,1432059105901,4533.96,0.0,384520.0,Essential,aastha,4080.56,453.4
365,366,27/01/2023,Health,True,1255603717286,2224.66,0.0,382295.34,Non-Essential,aastha,1779.73,444.93
366,367,27/01/2023,Tools,True,1271052123347,1392.9,0.0,380902.44,Important,aastha,1392.9,0.0
367,368,27/01/2023,Home,False,1981541776799,0.0,3384.43,384286.87,Important,aastha,0.0,0.0
368,369,27/01/2023,Baby,True,1949061726074,1453.97,0.0,382832.9,Non-important,aastha,1381.27,72.7
369,370,27/01/2023,Games,False,1827015547582,0.0,2058.2,384891.1,Non-important,aastha,0.0,0.0
370,371,27/01/2023,Electronics,False,1989411297619,0.0,4642.4,389533.5,Non-important,aastha,0.0,0.0
371,372,27/01/2023,Clothing,True,1351258824953,3503.99,0.0,386029.51,Essential,aastha,3153.59,350.4
372,373,27/01/2023,Home,False,1877040442554,0.0,4640.36,390669.87,Essential,aastha,0.0,0.0
373,374,27/01/2023,Books,False,1954646043152,0.0,1570.97,392240.84,Important,aastha,0.0,0.0
374,375,27/01/2023,Computers,False,1480338087486,0.0,3351.74,395592.58,Non-Essential,aastha,0.0,0.0
375,376,27/01/2023,Automotive,False,1129539749738,0.0,1932.09,397524.67,Non-important,aastha,0.0,0.0
376,377,28/01/2023,Tools,True,1078669577055,4141.06,0.0,393383.61,Non-important,aastha,3934.01,207.05
377,378,28/01/2023,Health,False,1894058559797,0.0,4536.03,397919.64,Non-Essential,aastha,0.0,0.0
378,379,28/01/2023,Shoes,False,1900850975836,0.0,3537.43,401457.07,Non-important,aastha,0.0,0.0
379,380,28/01/2023,Books,True,1988287166590,1880.06,0.0,399577.01,Essential,aastha,1692.05,188.01
380,381,28/01/2023,Automotive,False,1816669103276,0.0,3499.51,403076.52,Important,aastha,0.0,0.0
381,382,28/01/2023,Music,False,1770031707557,0.0,4990.88,408067.4,Essential,aastha,0.0,0.0
382,383,29/01/2023,Jewelry,False,1563959860428,0.0,679.33,408746.73,Non-Essential,aastha,0.0,0.0
383,384,29/01/2023,Kids,False,1211422192990,0.0,4235.27,412982.0,Essential,aastha,0.0,0.0
384,385,29/01/2023,Garden,False,1867030893723,0.0,1325.11,414307.11,Non-important,aastha,0.0,0.0
385,386,29/01/2023,Industrial,True,1219836777121,1834.04,0.0,412473.07,Essential,aastha,1650.64,183.4
386,387,29/01/2023,Automotive,False,1728140271995,0.0,3102.42,415575.49,Non-important,aastha,0.0,0.0
387,388,29/01/2023,Outdoors,False,1686544436732,0.0,1083.04,416658.53,Non-Essential,aastha,0.0,0.0
388,389,29/01/2023,Tools,True,1841355377209,3297.56,0.0,413360.97,Important,aastha,3297.56,0.0
389,390,29/01/2023,Automotive,False,1241147158418,0.0,3329.02,416689.99,Non-Essential,aastha,0.0,0.0
390,391,29/01/2023,Home,False,1501831553465,0.0,4510.59,421200.58,Non-important,aastha,0.0,0.0
391,392,29/01/2023,Beauty,False,1564300640105,0.0,3100.48,424301.06,Non-important,aastha,0.0,0.0
392,393,29/01/2023,Games,False,1096952933210,0.0,3316.42,427617.48,Non-important,aastha,0.0,0.0
393,394,29/01/2023,Automotive,True,1744626995641,3979.74,0.0,423637.74,Non-important,aastha,3780.75,198.99
394,395,29/01/2023,Books,True,1977021767865,2879.62,0.0,420758.12,Essential,aastha,2591.66,287.96
395,396,29/01/2023,Health,False,1615653697298,0.0,1405.19,422163.31,Non-important,aastha,0.0,0.0
396,397,30/01/2023,Industrial,True,1069943371024,4606.36,0.0,417556.95,Non-important,aastha,4376.04,230.32
397,398,30/01/2023,Outdoors,False,1642292935616,0.0,2635.57,420192.52,Important,aastha,0.0,0.0
398,399,30/01/2023,Toys,True,1636449361681,2829.61,0.0,417362.91,Essential,aastha,2546.65,282.96
399,400,30/01/2023,Grocery,True,1260964987266,4152.18,0.0,413210.73,Non-Essential,aastha,3321.74,830.44
400,401,30/01/2023,Tools,False,1983544253683,0.0,1370.53,414581.26,Non-important,aastha,0.0,0.0
401,402,30/01/2023,Music,True,1967472166313,1740.29,0.0,412840.97,Important,aastha,1740.29,0.0
402,403,30/01/2023,Tools,False,1461549829657,0.0,4781.5,417622.47,Important,aastha,0.0,0.0
403,404,30/01/2023,Home,False,1616855041071,0.0,4606.39,422228.86,Non-important,aastha,0.0,0.0
404,405,31/01/2023,Toys,False,1916221332918,0.0,4797.18,427026.04,Important,aastha,0.0,0.0
405,406,31/01/2023,Computers,True,1998576948360,4180.94,0.0,422845.1,Essential,aastha,3762.85,418.09
406,407,31/01/2023,Grocery,True,1149490654028,1694.85,0.0,421150.25,Important,aastha,1694.85,0.0
407,408,31/01/2023,Books,False,1727589790606,0.0,4562.39,425712.64,Essential,aastha,0.0,0.0
408,409,31/01/2023,Sports,False,1990808897998,0.0,3732.25,429444.89,Important,aastha,0.0,0.0
409,410,31/01/2023,Beauty,True,1757104058298,416.59,0.0,429028.3,Essential,aastha,374.93,41.66
410,411,31/01/2023,Sports,True,1343297815084,2503.83,0.0,426524.47,Essential,aastha,2253.45,250.38
411,412,01/02/2023,Toys,True,1125470562249,171.95,0.0,426352.52,Important,aastha,171.95,0.0
412,413,01/02/2023,Music,False,1114258188775,0.0,2504.88,428857.4,Important,aastha,0.0,0.0
413,414,01/02/2023,Home,True,1692533389588,597.57,0.0,428259.83,Essential,aastha,537.81,59.76
414,415,01/02/2023,Tools,False,1769813681811,0.0,3053.65,431313.48,Important,aastha,0.0,0.0
415,416,01/02/2023,Automotive,True,1259108685658,2197.06,0.0,429116.42,Important,aastha,2197.06,0.0
416,417,01/02/2023,Grocery,False,1615625104849,0.0,628.68,429745.1,Essential,aastha,0.0,0.0
417,418,01/02/2023,Tools,False,1472346640126,0.0,1476.77,431221.87,Essential,aastha,0.0,0.0
418,419,01/02/2023,Computers,True,1446720804102,3200.75,0.0,428021.12,Important,aastha,3200.75,0.0
419,420,01/02/2023,Shoes,False,1471735708193,0.0,4390.62,432411.74,Important,aastha,0.0,0.0
420,421,01/02/2023,Health,True,1443763483398,2326.25,0.0,430085.49,Essential,aastha,2093.62,232.62
421,422,02/02/2023,Kids,False,1574949919695,0.0,4383.56,434469.05,Non-Essential,aastha,0.0,0.0
422,423,02/02/2023,Beauty,True,1836443256409,3893.63,0.0,430575.42,Important,aastha,3893.63,0.0
423,424,02/02/2023,Books,True,1410930446287,344.17,0.0,430231.25,Non-Essential,aastha,275.34,68.83
424,425,02/02/2023,Garden,True,1190472918861,1356.86,0.0,428874.39,Important,aastha,1356.86,0.0
425,426,02/02/2023,Movies,True,1037913186181,4136.55,0.0,424737.84,Non-important,aastha,3929.72,206.83
426,427,02/02/2023,Automotive,True,1797234733652,3639.39,0.0,421098.45,Non-Essential,aastha,2911.51,727.88
427,428,02/02/2023,Clothing,False,1537883418150,0.0,1180.88,422279.33,Important,aastha,0.0,0.0
428,429,02/02/2023,Health,True,1631307725572,4441.75,0.0,417837.58,Important,aastha,4441.75,0.0
429,430,02/02/2023,Toys,False,1428594397059,0.0,3737.7,421575.28,Non-important,aastha,0.0,0.0
430,431,02/02/2023,Tools,True,1113591916056,3075.62,0.0,418499.66,Essential,aastha,2768.06,307.56
431,432,02/02/2023,Games,True,1466227065270,1418.65,0.0,417081.01,Important,aastha,1418.65,0.0
432,433,02/02/2023,Sports,True,1116411950511,2244.48,0.0,414836.53,Non-important,aastha,2132.26,112.22
433,434,02/02/2023,Computers,False,1283154480492,0.0,2022.82,416859.35,Non-important,aastha,0.0,0.0
434,435,02/02/2023,Jewelry,False,1979836872890,0.0,3211.46,420070.81,Non-Essential,aastha,0.0,0.0
435,436,03/02/2023,Movies,False,1656228510033,0.0,4452.73,424523.54,Essential,aastha,0.0,0.0
436,437,03/02/2023,Beauty,True,1346075177046,2793.44,0.0,421730.1,Non-Essential,aastha,2234.75,558.69
437,438,03/02/2023,Movies,False,1886902703247,0.0,1499.16,423229.26,Essential,aastha,0.0,0.0
438,439,03/02/2023,Movies,False,1713270210629,0.0,510.13,423739.39,Essential,aastha,0.0,0.0
439,440,03/02/2023,Health,False,1299304809835,0.0,4827.27,428566.66,Non-Essential,aastha,0.0,0.0
440,441,03/02/2023,Electronics,False,1491594877679,0.0,4369.01,432935.67,Important,aastha,0.0,0.0
441,442,03/02/2023,Home,True,1951360186931,2664.29,0.0,430271.38,Non-important,aastha,2531.08,133.21
442,443,03/02/2023,Toys,False,1757944726395,0.0,2013.5,432284.88,Non-important,aastha,0.0,0.0
443,444,03/02/2023,Outdoors,False,1145845184647,0.0,740.56,433025.44,Non-important,aastha,0.0,0.0
444,445,03/02/2023,Grocery,False,1581861894617,0.0,4971.89,437997.33,Non-Essential,aastha,0.0,0.0
445,446,03/02/2023,Clothing,False,1444459021990,0.0,3384.64,441381.97,Non-important,aastha,0.0,0.0
446,447,04/02/2023,Music,False,1316902193992,0.0,2464.96,443846.93,Essential,aastha,0.0,0.0
447,448,04/02/2023,Clothing,True,1741662371194,2082.81,0.0,441764.12,Non-important,aastha,1978.67,104.14
448,449,04/02/2023,Kids,False,1080884251842,0.0,1221.3,442985.42,Important,aastha,0.0,0.0
449,450,04/02/2023,Clothing,True,1563314936632,2652.72,0.0,440332.7,Important,aastha,2652.72,0.0
450,451,04/02/2023,Garden,True,1264936598539,3022.52,0.0,437310.18,Non-Essential,aastha,2418.02,604.5
451,452,04/02/2023,Shoes,False,1817014434252,0.0,4202.27,441512.45,Essential,aastha,0.0,0.0
452,453,04/02/2023,Beauty,False,1565423823208,0.0,1366.92,442879.37,Important,aastha,0.0,0.0
453,454,04/02/2023,Toys,True,1375609781022,3598.71,0.0,439280.66,Important,aastha,3598.71,0.0
454,455,04/02/2023,Outdoors,True,1124479636493,2645.68,0.0,436634.98,Important,aastha,2645.68,0.0
455,456,04/02/2023,Clothing,False,1197424074748,0.0,3284.15,439919.13,Non-Essential,aastha,0.0,0.0
456,457,04/02/2023,Tools,True,1309939255616,4819.31,0.0,435099.82,Essential,aastha,4337.38,481.93
457,458,04/02/2023,Home,False,1409908667482,0.0,2358.44,437458.26,Non-Essential,aastha,0.0,0.0
458,459,04/02/2023,Computers,False,1977307039596,0.0,2377.07,439835.33,Non-Essential,aastha,0.0,0.0
459,460,05/02/2023,Outdoors,False,1660335583528,0.0,2260.43,442095.76,Important,aastha,0.0,0.0
460,461,05/02/2023,Outdoors,True,1989883793477,1954.96,0.0,440140.8,Non-Essential,aastha,1563.97,390.99
461,462,05/02/2023,Outdoors,False,1637302733800,0.0,4017.55,444158.35,Essential,aastha,0.0,0.0
462,463,05/02/2023,Garden,True,1489660122722,4227.86,0.0,439930.49,Non-important,aastha,4016.47,211.39
463,464,05/02/2023,Health,True,1966660291023,1257.04,0.0,438673.45,Important,aastha,1257.04,0.0
464,465,05/02/2023,Jewelry,False,1026259250913,0.0,1926.78,440600.23,Important,aastha,0.0,0.0
465,466,05/02/2023,Automotive,False,1705908708674,0.0,10.31,440610.54,Non-Essential,aastha,0.0,0.0
466,467,05/02/2023,Beauty,False,1637079992727,0.0,3126.99,443737.53,Important,aastha,0.0,0.0
467,468,05/02/2023,Baby,False,1412817526119,0.0,2466.46,446203.99,Non-Essential,aastha,0.0,0.0
468,469,05/02/2023,Music,True,1698569787481,1436.14,0.0,444767.85,Non-Essential,aastha,1148.91,287.23
469,470,05/02/2023,Music,True,1652665180421,102.7,0.0,444665.15,Non-Essential,aastha,82.16,20.54
470,471,05/02/2023,Industrial,True,1095770083448,2078.64,0.0,442586.51,Important,aastha,2078.64,0.0
471,472,06/02/2023,Outdoors,False,1827231630879,0.0,1689.69,444276.2,Important,aastha,0.0,0.0
472,473,06/02/2023,Tools,False,1161205175327,0.0,2447.55,446723.75,Non-Essential,aastha,0.0,0.0
473,474,06/02/2023,Baby,False,1093363348059,0.0,4440.16,451163.91,Non-important,aastha,0.0,0.0
474,475,06/02/2023,Tools,False,1671405390288,0.0,3022.18,454186.09,Non-Essential,aastha,0.0,0.0
475,476,06/02/2023,Books,True,1145764332307,4157.03,0.0,450029.06,Non-Essential,aastha,3325.62,831.41
476,477,06/02/2023,Industrial,False,1708622676524,0.0,3609.82,453638.88,Essential,aastha,0.0,0.0
477,478,06/02/2023,Games,False,1547096234799,0.0,1159.53,454798.41,Non-Essential,aastha,0.0,0.0
478,479,06/02/2023,Music,True,1100266567234,1630.36,0.0,453168.05,Essential,aastha,1467.32,163.04
479,480,06/02/2023,Outdoors,True,1777206848005,3250.49,0.0,449917.56,Non-important,aastha,3087.97,162.52
480,481,06/02/2023,Garden,True,1793030808359,4042.19,0.0,445875.37,Essential,aastha,3637.97,404.22
481,482,06/02/2023,Music,False,1030640613593,0.0,3237.51,449112.88,Non-Essential,aastha,0.0,0.0
482,483,06/02/2023,Shoes,False,1866840438721,0.0,3305.8,452418.68,Non-important,aastha,0.0,0.0
483,484,06/02/2023,Kids,True,1665514036357,3785.22,0.0,448633.46,Non-important,aastha,3595.96,189.26
484,485,06/02/2023,Garden,True,1011942247530,4338.0,0.0,444295.46,Non-Essential,aastha,3470.4,867.6
485,486,06/02/2023,Toys,False,1293412932950,0.0,9.94,444305.4,Non-important,aastha,0.0,0.0
486,487,07/02/2023,Baby,True,1854280819917,4045.36,0.0,440260.04,Important,aastha,4045.36,0.0
487,488,07/02/2023,Games,False,1890512866509,0.0,3365.42,443625.46,Essential,aastha,0.0,0.0
488,489,07/02/2023,Garden,False,1843833390453,0.0,990.23,444615.69,Essential,aastha,0.0,0.0
489,490,07/02/2023,Music,False,1530666259951,0.0,3338.37,447954.06,Non-Essential,aastha,0.0,0.0
490,491,07/02/2023,Industrial,False,1518233015398,0.0,123.73,448077.79,Non-important,aastha,0.0,0.0
491,492,07/02/2023,Electronics,False,1618612244135,0.0,388.89,448466.68,Important,aastha,0.0,0.0
492,493,07/02/2023,Books,True,1420822818946,2868.49,0.0,445598.19,Essential,aastha,2581.64,286.85
493,494,07/02/2023,Garden,True,1065149886439,645.93,0.0,444952.26,Essential,aastha,581.34,64.59
494,495,07/02/2023,Books,False,1013453900353,0.0,2806.99,447759.25,Non-Essential,aastha,0.0,0.0
495,496,07/02/2023,Grocery,True,1675674260058,861.88,0.0,446897.37,Non-Essential,aastha,689.5,172.38
496,497,07/02/2023,Garden,True,1726874892412,3329.0,0.0,443568.37,Essential,aastha,2996.1,332.9
497,498,07/02/2023,Grocery,True,1308698917736,3227.14,0.0,440341.23,Important,aastha,3227.14,0.0
498,499,07/02/2023,Electronics,True,1349420482396,117.57,0.0,440223.66,Non-Essential,aastha,94.06,23.51
499,500,07/02/2023,Automotive,False,1769439620867,0.0,3154.34,443378.0,Essential,aastha,0.0,0.0
500,501,07/02/2023,Health,False,1346197961752,0.0,3368.14,446746.14,Non-important,aastha,0.0,0.0
501,502,07/02/2023,Baby,True,1856209701457,2592.79,0.0,444153.35,Non-Essential,aastha,2074.23,518.56
502,503,07/02/2023,Kids,False,1788686409284,0.0,70.63,444223.98,Non-important,aastha,0.0,0.0
503,504,08/02/2023,Electronics,True,1744988543021,2674.37,0.0,441549.61,Non-important,aastha,2540.65,133.72
504,505,08/02/2023,Movies,False,1776407072832,0.0,3327.47,444877.08,Essential,aastha,0.0,0.0
505,506,08/02/2023,Beauty,True,1217404813815,4464.13,0.0,440412.95,Non-important,aastha,4240.92,223.21
506,507,08/02/2023,Movies,True,1255397969068,4822.76,0.0,435590.19,Essential,aastha,4340.48,482.28
507,508,08/02/2023,Baby,True,1445257966928,3579.28,0.0,432010.91,Important,aastha,3579.28,0.0
508,509,08/02/2023,Clothing,True,1390138372921,727.92,0.0,431282.99,Non-important,aastha,691.52,36.4
509,510,08/02/2023,Health,True,1571513280814,2439.0,0.0,428843.99,Non-Essential,aastha,1951.2,487.8
510,511,09/02/2023,Automotive,False,1063392797850,0.0,4332.76,433176.75,Important,aastha,0.0,0.0
511,512,09/02/2023,Toys,True,1219318189172,3199.97,0.0,429976.78,Important,aastha,3199.97,0.0
512,513,09/02/2023,Automotive,False,1274492537425,0.0,1572.5,431549.28,Non-Essential,aastha,0.0,0.0
513,514,09/02/2023,Beauty,False,1616280765460,0.0,4851.35,436400.63,Important,aastha,0.0,0.0
514,515,09/02/2023,Kids,True,1080097548211,2730.88,0.0,433669.75,Essential,aastha,2457.79,273.09
515,516,10/02/2023,Grocery,True,1106397365424,1458.99,0.0,432210.76,Essential,aastha,1313.09,145.9
516,517,10/02/2023,Movies,True,1487465552573,4409.39,0.0,427801.37,Non-important,aastha,4188.92,220.47
517,518,10/02/2023,Computers,False,1295077720368,0.0,3803.76,431605.13,Non-Essential,aastha,0.0,0.0
518,519,10/02/2023,Baby,False,1540105458175,0.0,2392.78,433997.91,Non-important,aastha,0.0,0.0
519,520,10/02/2023,Industrial,True,1443949999452,1262.5,0.0,432735.41,Essential,aastha,1136.25,126.25
520,521,10/02/2023,Industrial,True,1028262808019,2075.39,0.0,430660.02,Non-Essential,aastha,1660.31,415.08
521,522,10/02/2023,Music,True,1282724531800,41.98,0.0,430618.04,Important,aastha,41.98,0.0
522,523,10/02/2023,Jewelry,True,1718711543341,4997.75,0.0,425620.29,Non-Essential,aastha,3998.2,999.55
523,524,10/02/2023,Sports,True,1655911059822,1418.59,0.0,424201.7,Non-important,aastha,1347.66,70.93
524,525,10/02/2023,Computers,True,1062513507779,3765.52,0.0,420436.18,Essential,aastha,3388.97,376.55
525,526,10/02/2023,Electronics,True,1101621895736,2737.17,0.0,417699.01,Important,aastha,2737.17,0.0
526,527,10/02/2023,Automotive,False,1705455694033,0.0,1869.03,419568.04,Non-important,aastha,0.0,0.0
527,528,10/02/2023,Music,True,1504972087286,2498.37,0.0,417069.67,Non-important,aastha,2373.45,124.92
528,529,10/02/2023,Baby,False,1706858682472,0.0,4445.98,421515.65,Non-important,aastha,0.0,0.0
529,530,10/02/2023,Sports,False,1005867453522,0.0,4998.67,426514.32,Non-important,aastha,0.0,0.0
530,531,10/02/2023,Electronics,True,1541922178385,61.8,0.0,426452.52,Essential,aastha,55.62,6.18
531,532,11/02/2023,Baby,True,1620543804024,894.41,0.0,425558.11,Important,aastha,894.41,0.0
532,533,11/02/2023,Shoes,False,1219046720496,0.0,2095.8,427653.91,Non-Essential,aastha,0.0,0.0
533,534,11/02/2023,Tools,False,1644676126871,0.0,1864.32,429518.23,Non-important,aastha,0.0,0.0
534,535,11/02/2023,Computers,False,1644745580857,0.0,2544.78,432063.01,Non-important,aastha,0.0,0.0
535,536,11/02/2023,Home,False,1138531017035,0.0,169.3,432232.31,Non-Essential,aastha,0.0,0.0
536,537,11/02/2023,Electronics,False,1794626090832,0.0,2764.22,434996.53,Important,aastha,0.0,0.0
537,538,11/02/2023,Music,False,1573745007870,0.0,4513.43,439509.96,Essential,aastha,0.0,0.0
538,539,11/02/2023,Clothing,True,1182976418599,685.84,0.0,438824.12,Important,aastha,685.84,0.0
539,540,11/02/2023,Kids,False,1253532798111,0.0,99.52,438923.64,Non-important,aastha,0.0,0.0
540,541,12/02/2023,Clothing,True,1748254749942,4036.85,0.0,434886.79,Important,aastha,4036.85,0.0
541,542,12/02/2023,Shoes,True,1005814977405,4309.23,0.0,430577.56,Non-Essential,aastha,3447.38,861.85
542,543,12/02/2023,Clothing,True,1489193553074,2240.37,0.0,428337.19,Non-important,aastha,2128.35,112.02
543,544,12/02/2023,Grocery,True,1989889692453,4078.68,0.0,424258.51,Non-important,aastha,3874.75,203.93
544,545,12/02/2023,Industrial,True,1895065401490,2119.82,0.0,422138.69,Non-important,aastha,2013.83,105.99
545,546,12/02/2023,Sports,True,1176901433873,591.21,0.0,421547.48,Non-Essential,aastha,472.97,118.24
546,547,12/02/2023,Home,False,1933312860727,0.0,2647.91,424195.39,Non-Essential,aastha,0.0,0.0
547,548,12/02/2023,Kids,False,1666632280840,0.0,1043.04,425238.43,Non-Essential,aastha,0.0,0.0
548,549,12/02/2023,Tools,True,1418520556378,3411.54,0.0,421826.89,Essential,aastha,3070.39,341.15
549,550,12/02/2023,Grocery,False,1077138790738,0.0,3603.5,425430.39,Important,aastha,0.0,0.0
550,551,12/02/2023,Garden,True,1350392235068,4980.0,0.0,420450.39,Non-important,aastha,4731.0,249.0
551,552,12/02/2023,Clothing,False,1182154683149,0.0,4144.59,424594.98,Non-important,aastha,0.0,0.0
552,553,13/02/2023,Kids,True,1178054301602,3530.1,0.0,421064.88,Non-important,aastha,3353.59,176.5
553,554,13/02/2023,Health,False,1618626079184,0.0,459.51,421524.39,Non-important,aastha,0.0,0.0
554,555,13/02/2023,Computers,True,1149882909742,78.16,0.0,421446.23,Essential,aastha,70.34,7.82
555,556,13/02/2023,Music,True,1721720809548,2834.53,0.0,418611.7,Non-important,aastha,2692.8,141.73
556,557,13/02/2023,Games,False,1932229674794,0.0,281.24,418892.94,Important,aastha,0.0,0.0
557,558,13/02/2023,Movies,False,1913575267505,0.0,1430.54,420323.48,Important,aastha,0.0,0.0
558,559,13/02/2023,Games,True,1342216455547,3163.95,0.0,417159.53,Non-important,aastha,3005.75,158.2
559,560,13/02/2023,Toys,True,1725286689088,4353.34,0.0,412806.19,Non-important,aastha,4135.67,217.67
560,561,13/02/2023,Tools,True,1652886852387,2017.91,0.0,410788.28,Non-Essential,aastha,1614.33,403.58
561,562,13/02/2023,Garden,False,1621592238862,0.0,4288.89,415077.17,Non-Essential,aastha,0.0,0.0
562,563,13/02/2023,Outdoors,True,1917536433211,2890.83,0.0,412186.34,Non-important,aastha,2746.29,144.54
563,564,14/02/2023,Toys,False,1628885081946,0.0,2660.95,414847.29,Essential,aastha,0.0,0.0
564,565,14/02/2023,Books,False,1434578758325,0.0,4470.42,419317.71,Non-Essential,aastha,0.0,0.0
565,566,14/02/2023,Beauty,True,1944220652643,1704.51,0.0,417613.2,Essential,aastha,1534.06,170.45
566,567,14/02/2023,Movies,True,1480710481554,4553.59,0.0,413059.61,Non-Essential,aastha,3642.87,910.72
567,568,14/02/2023,Clothing,False,1191006829733,0.0,3438.63,416498.24,Non-Essential,aastha,0.0,0.0
568,569,14/02/2023,Books,True,1106550359833,941.73,0.0,415556.51,Non-Essential,aastha,753.38,188.35
569,570,14/02/2023,Home,True,1885195386414,4402.56,0.0,411153.95,Non-important,aastha,4182.43,220.13
570,571,14/02/2023,Games,False,1534838516017,0.0,4399.36,415553.31,Important,aastha,0.0,0.0
571,572,14/02/2023,Electronics,True,1193687242376,2992.57,0.0,412560.74,Essential,aastha,2693.31,299.26
572,573,14/02/2023,Baby,True,1659417319880,2390.25,0.0,410170.49,Non-Essential,aastha,1912.2,478.05
573,574,14/02/2023,Shoes,True,1977262430926,4066.47,0.0,406104.02,Non-important,aastha,3863.15,203.32
574,575,14/02/2023,Health,False,1617230307192,0.0,3490.89,409594.91,Important,aastha,0.0,0.0
575,576,15/02/2023,Toys,False,1193669770982,0.0,4360.55,413955.46,Essential,aastha,0.0,0.0
576,577,15/02/2023,Garden,False,1870094142906,0.0,4207.35,418162.81,Non-important,aastha,0.0,0.0
577,578,15/02/2023,Toys,True,1651154570603,3845.61,0.0,414317.2,Important,aastha,3845.61,0.0
578,579,15/02/2023,Sports,False,1785873648175,0.0,4385.05,418702.25,Important,aastha,0.0,0.0
579,580,15/02/2023,Games,True,1278376602958,2375.11,0.0,416327.14,Important,aastha,2375.11,0.0
580,581,15/02/2023,Tools,True,1987548427500,3220.42,0.0,413106.72,Non-important,aastha,3059.4,161.02
581,582,15/02/2023,Industrial,True,1502140873948,2600.98,0.0,410505.74,Important,aastha,2600.98,0.0
582,583,15/02/2023,Computers,True,1994317670764,354.71,0.0,410151.03,Non-Essential,aastha,283.77,70.94
583,584,15/02/2023,Outdoors,True,1395755217648,514.67,0.0,409636.36,Important,aastha,514.67,0.0
584,585,15/02/2023,Grocery,False,1220399197050,0.0,2306.48,411942.84,Non-Essential,aastha,0.0,0.0
585,586,15/02/2023,Clothing,False,1008558453438,0.0,3566.72,415509.56,Non-Essential,aastha,0.0,0.0
586,587,15/02/2023,Clothing,False,1899111740786,0.0,1153.78,416663.34,Non-important,aastha,0.0,0.0
587,588,15/02/2023,Automotive,False,1983610695379,0.0,3843.13,420506.47,Non-important,aastha,0.0,0.0
588,589,16/02/2023,Beauty,False,1061805499468,0.0,2192.55,422699.02,Non-Essential,aastha,0.0,0.0
589,590,16/02/2023,Automotive,False,1593988012453,0.0,2041.24,424740.26,Non-important,aastha,0.0,0.0
590,591,16/02/2023,Health,True,1115844691494,3131.01,0.0,421609.25,Non-important,aastha,2974.46,156.55
591,592,16/02/2023,Computers,False,1409325267907,0.0,3517.87,425127.12,Important,aastha,0.0,0.0
592,593,16/02/2023,Grocery,False,1929024911192,0.0,3200.62,428327.74,Non-important,aastha,0.0,0.0
593,594,16/02/2023,Grocery,True,1443426309421,3274.57,0.0,425053.17,Non-important,aastha,3110.84,163.73
594,595,16/02/2023,Computers,True,1846786414262,454.76,0.0,424598.41,Non-Essential,aastha,363.81,90.95
595,596,16/02/2023,Jewelry,False,1628341540046,0.0,1862.1,426460.51,Important,aastha,0.0,0.0
596,597,16/02/2023,Health,False,1215713296893,0.0,1050.37,427510.88,Non-important,aastha,0.0,0.0
597,598,16/02/2023,Beauty,False,1501086558200,0.0,825.37,428336.25,Essential,aastha,0.0,0.0
598,599,17/02/2023,Shoes,True,1601895971056,2198.95,0.0,426137.3,Important,aastha,2198.95,0.0
599,600,17/02/2023,Electronics,True,1786542532966,1852.08,0.0,424285.22,Non-important,aastha,1759.48,92.6
600,601,17/02/2023,Health,True,1482077287680,4754.03,0.0,419531.19,Important,aastha,4754.03,0.0
601,602,17/02/2023,Beauty,True,1908892197357,1146.47,0.0,418384.72,Important,aastha,1146.47,0.0
602,603,17/02/2023,Jewelry,True,1551467585873,173.72,0.0,418211.0,Non-Essential,aastha,138.98,34.74
603,604,17/02/2023,Baby,False,1811940456087,0.0,540.16,418751.16,Essential,aastha,0.0,0.0
604,605,17/02/2023,Computers,False,1625659848129,0.0,2306.51,421057.67,Essential,aastha,0.0,0.0
605,606,17/02/2023,Tools,True,1360106808895,770.41,0.0,420287.26,Important,aastha,770.41,0.0
606,607,18/02/2023,Computers,True,1617620725441,1972.66,0.0,418314.6,Important,aastha,1972.66,0.0
607,608,18/02/2023,Movies,True,1307207787787,4943.94,0.0,413370.66,Essential,aastha,4449.55,494.39
608,609,18/02/2023,Toys,False,1010624348072,0.0,3942.98,417313.64,Non-important,aastha,0.0,0.0
609,610,18/02/2023,Electronics,True,1199672450258,4741.43,0.0,412572.21,Non-Essential,aastha,3793.14,948.29
610,611,18/02/2023,Sports,False,1178181385777,0.0,3334.48,415906.69,Non-Essential,aastha,0.0,0.0
611,612,18/02/2023,Baby,True,1172216879086,1823.26,0.0,414083.43,Essential,aastha,1640.93,182.33
612,613,18/02/2023,Tools,False,1906218220702,0.0,3586.49,417669.92,Important,aastha,0.0,0.0
613,614,18/02/2023,Sports,False,1155118385147,0.0,3315.36,420985.28,Important,aastha,0.0,0.0
614,615,18/02/2023,Clothing,False,1593862119320,0.0,1774.57,422759.85,Important,aastha,0.0,0.0
615,616,19/02/2023,Tools,False,1638373599254,0.0,2341.95,425101.8,Essential,aastha,0.0,0.0
616,617,19/02/2023,Industrial,True,1947371443046,2820.14,0.0,422281.66,Non-Essential,aastha,2256.11,564.03
617,618,19/02/2023,Grocery,True,1982402938287,1135.69,0.0,421145.97,Important,aastha,1135.69,0.0
618,619,19/02/2023,Movies,False,1114938498491,0.0,4125.4,425271.37,Non-important,aastha,0.0,0.0
619,620,19/02/2023,Jewelry,True,1605714258507,1868.08,0.0,423403.29,Non-important,aastha,1774.68,93.4
620,621,19/02/2023,Jewelry,True,1557722692091,2825.55,0.0,420577.74,Non-important,aastha,2684.27,141.28
621,622,19/02/2023,Garden,False,1427254539066,0.0,3584.8,424162.54,Important,aastha,0.0,0.0
622,623,19/02/2023,Music,True,1716455029093,552.7,0.0,423609.84,Essential,aastha,497.43,55.27
623,624,19/02/2023,Baby,False,1232803570985,0.0,382.46,423992.3,Important,aastha,0.0,0.0
624,625,19/02/2023,Home,True,1028684285626,2144.83,0.0,421847.47,Essential,aastha,1930.35,214.48
625,626,19/02/2023,Jewelry,False,1123077938549,0.0,2904.2,424751.67,Important,aastha,0.0,0.0
626,627,19/02/2023,Toys,True,1534633661450,1889.98,0.0,422861.69,Non-important,aastha,1795.48,94.5
627,628,20/02/2023,Garden,False,1866984846787,0.0,4583.68,427445.37,Non-Essential,aastha,0.0,0.0
628,629,20/02/2023,Shoes,False,1892803789387,0.0,1302.95,428748.32,Non-important,aastha,0.0,0.0
629,630,20/02/2023,Toys,True,1071380628136,1498.8,0.0,427249.52,Non-important,aastha,1423.86,74.94
630,631,20/02/2023,Kids,False,1181530463564,0.0,2896.23,430145.75,Essential,aastha,0.0,0.0
631,632,20/02/2023,Garden,True,1187732274492,4995.78,0.0,425149.97,Important,aastha,4995.78,0.0
632,633,20/02/2023,Home,False,1268750499015,0.0,1233.38,426383.35,Essential,aastha,0.0,0.0
633,634,20/02/2023,Baby,True,1425222926460,1540.83,0.0,424842.52,Important,aastha,1540.83,0.0
634,635,20/02/2023,Industrial,False,1856759028611,0.0,2482.05,427324.57,Important,aastha,0.0,0.0
635,636,20/02/2023,Shoes,True,1504360235091,3768.97,0.0,423555.6,Important,aastha,3768.97,0.0
636,637,20/02/2023,Shoes,False,1935306543027,0.0,3154.79,426710.39,Essential,aastha,0.0,0.0
637,638,20/02/2023,Garden,False,1633550838012,0.0,950.67,427661.06,Important,aastha,0.0,0.0
638,639,20/02/2023,Shoes,False,1753059339194,0.0,1859.29,429520.35,Non-important,aastha,0.0,0.0
639,640,20/02/2023,Sports,True,1682238407818,3272.13,0.0,426248.22,Important,aastha,3272.13,0.0
640,641,21/02/2023,Beauty,False,1648663945275,0.0,4375.43,430623.65,Non-Essential,aastha,0.0,0.0
641,642,21/02/2023,Beauty,True,1565234729984,4370.12,0.0,426253.53,Non-important,aastha,4151.61,218.51
642,643,21/02/2023,Outdoors,False,1851045966064,0.0,4565.81,430819.34,Essential,aastha,0.0,0.0
643,644,21/02/2023,Electronics,True,1881677661830,3555.88,0.0,427263.46,Non-Essential,aastha,2844.7,711.18
644,645,21/02/2023,Electronics,True,1953587821558,1117.16,0.0,426146.3,Essential,aastha,1005.44,111.72
645,646,21/02/2023,Grocery,False,1789885398587,0.0,350.37,426496.67,Non-Essential,aastha,0.0,0.0
646,647,21/02/2023,Computers,False,1371884096840,0.0,1083.38,427580.05,Essential,aastha,0.0,0.0
647,648,21/02/2023,Garden,False,1666032353202,0.0,1967.17,429547.22,Non-Essential,aastha,0.0,0.0
648,649,22/02/2023,Books,False,1128637197729,0.0,2823.52,432370.74,Important,aastha,0.0,0.0
649,650,22/02/2023,Baby,True,1086811059409,3937.09,0.0,428433.65,Essential,aastha,3543.38,393.71
650,651,22/02/2023,Sports,True,1305505232409,2453.66,0.0,425979.99,Non-important,aastha,2330.98,122.68
651,652,22/02/2023,Toys,True,1267660826994,4113.61,0.0,421866.38,Important,aastha,4113.61,0.0
652,653,22/02/2023,Grocery,True,1188253263493,3924.61,0.0,417941.77,Important,aastha,3924.61,0.0
653,654,22/02/2023,Computers,False,1492107557496,0.0,687.64,418629.41,Non-important,aastha,0.0,0.0
654,655,22/02/2023,Tools,True,1438491209638,4427.33,0.0,414202.08,Non-Essential,aastha,3541.86,885.47
655,656,22/02/2023,Music,True,1014119233189,2480.89,0.0,411721.19,Non-Essential,aastha,1984.71,496.18
656,657,22/02/2023,Health,False,1914000588330,0.0,2161.8,413882.99,Non-Essential,aastha,0.0,0.0
657,658,22/02/2023,Health,False,1554103478891,0.0,33.18,413916.17,Important,aastha,0.0,0.0
658,659,22/02/2023,Clothing,True,1148827051077,894.93,0.0,413021.24,Essential,aastha,805.44,89.49
659,660,22/02/2023,Beauty,False,1274127331917,0.0,387.58,413408.82,Important,aastha,0.0,0.0
660,661,22/02/2023,Computers,True,1351379196577,3032.81,0.0,410376.01,Non-important,aastha,2881.17,151.64
661,662,22/02/2023,Sports,True,1593626895720,2922.05,0.0,407453.96,Non-Essential,aastha,2337.64,584.41
662,663,23/02/2023,Movies,True,1303389282819,1961.4,0.0,405492.56,Essential,aastha,1765.26,196.14
663,664,23/02/2023,Outdoors,False,1104688275895,0.0,4404.2,409896.76,Non-important,aastha,0.0,0.0
664,665,23/02/2023,Music,True,1493348518569,3125.43,0.0,406771.33,Essential,aastha,2812.89,312.54
665,666,23/02/2023,Industrial,False,1569565535634,0.0,504.66,407275.99,Non-Essential,aastha,0.0,0.0
666,667,23/02/2023,Shoes,True,1260036659323,1015.1,0.0,406260.89,Important,aastha,1015.1,0.0
667,668,23/02/2023,Movies,True,1266694855297,4393.39,0.0,401867.5,Essential,aastha,3954.05,439.34
668,669,23/02/2023,Books,True,1039635528952,1264.26,0.0,400603.24,Non-important,aastha,1201.05,63.21
669,670,23/02/2023,Toys,True,1995050711013,1858.19,0.0,398745.05,Important,aastha,1858.19,0.0
670,671,23/02/2023,Clothing,True,1120829522309,706.48,0.0,398038.57,Essential,aastha,635.83,70.65
671,672,23/02/2023,Grocery,False,1209043078862,0.0,3357.76,401396.33,Non-Essential,aastha,0.0,0.0
672,673,23/02/2023,Industrial,True,1279229550184,3989.02,0.0,397407.31,Essential,aastha,3590.12,398.9
673,674,23/02/2023,Jewelry,True,1395371168633,1263.83,0.0,396143.48,Essential,aastha,1137.45,126.38
674,675,24/02/2023,Health,True,1433833466242,767.91,0.0,395375.57,Non-important,aastha,729.51,38.4
675,676,24/02/2023,Clothing,False,1807527122584,0.0,1353.17,396728.74,Important,aastha,0.0,0.0
676,677,24/02/2023,Toys,True,1296673955247,4861.09,0.0,391867.65,Non-Essential,aastha,3888.87,972.22
677,678,24/02/2023,Electronics,False,1945698214521,0.0,2966.65,394834.3,Important,aastha,0.0,0.0
678,679,24/02/2023,Grocery,False,1887139018233,0.0,2907.68,397741.98,Non-Essential,aastha,0.0,0.0
679,680,24/02/2023,Books,False,1381087546517,0.0,2904.1,400646.08,Important,aastha,0.0,0.0
680,681,24/02/2023,Beauty,False,1763995784403,0.0,4408.06,405054.14,Important,aastha,0.0,0.0
681,682,24/02/2023,Industrial,True,1122635939596,2984.2,0.0,402069.94,Essential,aastha,2685.78,298.42
682,683,24/02/2023,Electronics,True,1284807223742,3548.21,0.0,398521.73,Essential,aastha,3193.39,354.82
683,684,24/02/2023,Movies,False,1761427914548,0.0,4034.54,402556.27,Important,aastha,0.0,0.0
684,685,25/02/2023,Movies,True,1674793738056,3251.67,0.0,399304.6,Essential,aastha,2926.5,325.17
685,686,25/02/2023,Home,True,1511944453053,745.19,0.0,398559.41,Essential,aastha,670.67,74.52
686,687,25/02/2023,Industrial,True,1749257504035,2317.57,0.0,396241.84,Essential,aastha,2085.81,231.76
687,688,25/02/2023,Outdoors,True,1742744391561,8.81,0.0,396233.03,Important,aastha,8.81,0.0
688,689,25/02/2023,Home,True,1849549140637,25.46,0.0,396207.57,Non-important,aastha,24.19,1.27
689,690,25/02/2023,Grocery,False,1658355646511,0.0,2381.55,398589.12,Important,aastha,0.0,0.0
690,691,25/02/2023,Baby,False,1277046230722,0.0,1785.79,400374.91,Non-important,aastha,0.0,0.0
691,692,25/02/2023,Home,False,1469081565053,0.0,4053.38,404428.29,Non-Essential,aastha,0.0,0.0
692,693,25/02/2023,Outdoors,True,1844985922518,3721.45,0.0,400706.84,Non-important,aastha,3535.38,186.07
693,694,25/02/2023,Industrial,True,1624253629070,4598.4,0.0,396108.44,Non-Essential,aastha,3678.72,919.68
694,695,25/02/2023,Books,False,1222139913565,0.0,2747.85,398856.29,Non-important,aastha,0.0,0.0
695,696,25/02/2023,Computers,True,1470243877514,3729.28,0.0,395127.01,Essential,aastha,3356.35,372.93
696,697,25/02/2023,Health,False,1440822011044,0.0,3037.06,398164.07,Essential,aastha,0.0,0.0
697,698,25/02/2023,Tools,False,1206793320992,0.0,1369.85,399533.92,Non-important,aastha,0.0,0.0
698,699,25/02/2023,Shoes,False,1679985373809,0.0,3357.42,402891.34,Essential,aastha,0.0,0.0
699,700,26/02/2023,Computers,True,1641065125595,3098.96,0.0,399792.38,Essential,aastha,2789.06,309.9
700,701,26/02/2023,Games,True,1837433516245,162.87,0.0,399629.51,Essential,aastha,146.58,16.29
701,702,26/02/2023,Grocery,False,1587590581415,0.0,2739.69,402369.2,Non-important,aastha,0.0,0.0
702,703,26/02/2023,Toys,False,1908356641853,0.0,4954.95,407324.15,Essential,aastha,0.0,0.0
703,704,26/02/2023,Beauty,False,1030471886384,0.0,2099.52,409423.67,Non-Essential,aastha,0.0,0.0
704,705,26/02/2023,Clothing,True,1814734043929,2725.26,0.0,406698.41,Non-important,aastha,2589.0,136.26
705,706,26/02/2023,Computers,True,1336717025227,3004.58,0.0,403693.83,Essential,aastha,2704.12,300.46
706,707,26/02/2023,Sports,True,1827187672760,1159.65,0.0,402534.18,Essential,aastha,1043.69,115.97
707,708,26/02/2023,Toys,True,1550879140589,3017.86,0.0,399516.32,Important,aastha,3017.86,0.0
708,709,26/02/2023,Outdoors,False,1594840678111,0.0,425.17,399941.49,Important,aastha,0.0,0.0
709,710,26/02/2023,Outdoors,False,1848811936632,0.0,2619.02,402560.51,Essential,aastha,0.0,0.0
710,711,27/02/2023,Baby,False,1832386593212,0.0,2581.31,405141.82,Essential,aastha,0.0,0.0
711,712,27/02/2023,Computers,False,1727711748540,0.0,4864.05,410005.87,Essential,aastha,0.0,0.0
712,713,27/02/2023,Movies,True,1490001949963,3902.15,0.0,406103.72,Important,aastha,3902.15,0.0
713,714,27/02/2023,Computers,False,1334379384972,0.0,38.83,406142.55,Non-important,aastha,0.0,0.0
714,715,27/02/2023,Electronics,True,1958671454539,3336.53,0.0,402806.02,Important,aastha,3336.53,0.0
715,716,27/02/2023,Shoes,False,1276452897805,0.0,3664.36,406470.38,Non-Essential,aastha,0.0,0.0
716,717,27/02/2023,Beauty,True,1559236842210,1511.34,0.0,404959.04,Essential,aastha,1360.21,151.13
717,718,27/02/2023,Outdoors,True,1872751505215,756.75,0.0,404202.29,Important,aastha,756.75,0.0
718,719,27/02/2023,Electronics,True,1207039945648,2914.47,0.0,401287.82,Non-important,aastha,2768.75,145.72
719,720,28/02/2023,Garden,False,1590661665921,0.0,2348.5,403636.32,Non-Essential,aastha,0.0,0.0
720,721,28/02/2023,Garden,True,1937224174141,2481.34,0.0,401154.98,Non-Essential,aastha,1985.07,496.27
721,722,28/02/2023,Shoes,False,1576070738745,0.0,705.74,401860.72,Non-important,aastha,0.0,0.0
722,723,28/02/2023,Games,True,1591572377362,1259.71,0.0,400601.01,Non-important,aastha,1196.72,62.99
723,724,28/02/2023,Toys,False,1567025922386,0.0,201.41,400802.42,Essential,aastha,0.0,0.0
724,725,28/02/2023,Kids,False,1481244698715,0.0,1326.69,402129.11,Essential,aastha,0.0,0.0
725,726,28/02/2023,Health,True,1813078180016,4974.68,0.0,397154.43,Essential,aastha,4477.21,497.47
726,727,28/02/2023,Home,True,1596430510340,1483.95,0.0,395670.48,Non-important,aastha,1409.75,74.2
727,728,28/02/2023,Baby,True,1740122438662,1997.61,0.0,393672.87,Essential,aastha,1797.85,199.76
728,729,28/02/2023,Garden,True,1878234568492,4938.04,0.0,388734.83,Essential,aastha,4444.24,493.8
729,730,28/02/2023,Books,False,1366595177417,0.0,3278.28,392013.11,Important,aastha,0.0,0.0
730,731,28/02/2023,Grocery,True,1644907509788,1977.24,0.0,390035.87,Important,aastha,1977.24,0.0
731,732,28/02/2023,Sports,False,1448090155322,0.0,3549.39,393585.26,Essential,aastha,0.0,0.0
732,733,28/02/2023,Computers,False,1776454331109,0.0,4657.45,398242.71,Non-Essential,aastha,0.0,0.0
733,734,28/02/2023,Outdoors,True,1106721389665,1675.19,0.0,396567.52,Non-Essential,aastha,1340.15,335.04
734,735,01/03/2023,Electronics,True,1374047419010,3165.96,0.0,393401.56,Non-Essential,aastha,2532.77,633.19
735,736,01/03/2023,Shoes,True,1112027218327,3881.72,0.0,389519.84,Essential,aastha,3493.55,388.17
736,737,01/03/2023,Music,False,1229239114358,0.0,1143.87,390663.71,Non-Essential,aastha,0.0,0.0
737,738,01/03/2023,Tools,True,1094065001498,3222.19,0.0,387441.52,Essential,aastha,2899.97,322.22
738,739,01/03/2023,Movies,True,1777620874711,2250.91,0.0,385190.61,Essential,aastha,2025.82,225.09
739,740,01/03/2023,Clothing,True,1212421833235,4645.96,0.0,380544.65,Important,aastha,4645.96,0.0
740,741,01/03/2023,Industrial,True,1127218850059,1673.43,0.0,378871.22,Essential,aastha,1506.09,167.34
741,742,01/03/2023,Outdoors,True,1005705052080,4798.94,0.0,374072.28,Important,aastha,4798.94,0.0
742,743,01/03/2023,Automotive,True,1004057633645,2324.35,0.0,371747.93,Important,aastha,2324.35,0.0
743,744,01/03/2023,Clothing,False,1939610701463,0.0,647.2,372395.13,Non-Essential,aastha,0.0,0.0
744,745,01/03/2023,Automotive,False,1166180413858,0.0,922.25,373317.38,Non-Essential,aastha,0.0,0.0
745,746,01/03/2023,Sports,False,1022279362158,0.0,4051.43,377368.81,Non-Essential,aastha,0.0,0.0
746,747,01/03/2023,Industrial,True,1825212223089,1712.05,0.0,375656.76,Essential,aastha,1540.85,171.21
747,748,02/03/2023,Games,False,1380999766819,0.0,4408.7,380065.46,Non-important,aastha,0.0,0.0
748,749,02/03/2023,Shoes,False,1228665257573,0.0,4780.61,384846.07,Non-Essential,aastha,0.0,0.0
749,750,02/03/2023,Industrial,False,1532765013073,0.0,4020.09,388866.16,Essential,aastha,0.0,0.0
750,751,02/03/2023,Tools,False,1015496645781,0.0,4200.05,393066.21,Non-Essential,aastha,0.0,0.0
751,752,02/03/2023,Automotive,True,1342762604543,131.25,0.0,392934.96,Non-Essential,aastha,105.0,26.25
752,753,02/03/2023,Baby,False,1487717810684,0.0,3945.69,396880.65,Non-important,aastha,0.0,0.0
753,754,02/03/2023,Garden,True,1499355645673,3151.28,0.0,393729.37,Essential,aastha,2836.15,315.13
754,755,02/03/2023,Outdoors,False,1853260630538,0.0,2852.4,396581.77,Non-important,aastha,0.0,0.0
755,756,02/03/2023,Jewelry,False,1117810818118,0.0,3148.39,399730.16,Non-Essential,aastha,0.0,0.0
756,757,03/03/2023,Health,False,1656837104464,0.0,3937.18,403667.34,Non-important,aastha,0.0,0.0
757,758,03/03/2023,Computers,False,1766087023469,0.0,4515.23,408182.57,Non-Essential,aastha,0.0,0.0
758,759,03/03/2023,Grocery,True,1226979948821,1463.31,0.0,406719.26,Non-Essential,aastha,1170.65,292.66
759,760,03/03/2023,Computers,False,1430033936147,0.0,992.28,407711.54,Important,aastha,0.0,0.0
760,761,03/03/2023,Outdoors,False,1085916716293,0.0,4461.82,412173.36,Essential,aastha,0.0,0.0
761,762,03/03/2023,Games,True,1231599451448,2567.13,0.0,409606.23,Important,aastha,2567.13,0.0
762,763,03/03/2023,Sports,True,1973943367777,1135.05,0.0,408471.18,Non-important,aastha,1078.3,56.75
763,764,03/03/2023,Shoes,False,1170165942708,0.0,4514.39,412985.57,Non-important,aastha,0.0,0.0
764,765,03/03/2023,Toys,True,1173364029787,335.67,0.0,412649.9,Essential,aastha,302.1,33.57
765,766,03/03/2023,Home,False,1421433544364,0.0,386.29,413036.19,Important,aastha,0.0,0.0
766,767,04/03/2023,Outdoors,True,1535339216872,1694.37,0.0,411341.82,Non-Essential,aastha,1355.5,338.87
767,768,04/03/2023,Electronics,False,1072244107746,0.0,1390.54,412732.36,Non-Essential,aastha,0.0,0.0
768,769,04/03/2023,Clothing,True,1726618253263,4966.06,0.0,407766.3,Non-Essential,aastha,3972.85,993.21
769,770,04/03/2023,Automotive,True,1535404869100,2436.44,0.0,405329.86,Essential,aastha,2192.8,243.64
770,771,04/03/2023,Music,False,1554171420230,0.0,2444.25,407774.11,Essential,aastha,0.0,0.0
771,772,04/03/2023,Shoes,False,1637236889851,0.0,745.24,408519.35,Essential,aastha,0.0,0.0
772,773,04/03/2023,Toys,False,1380708958386,0.0,52.06,408571.41,Important,aastha,0.0,0.0
773,774,04/03/2023,Tools,True,1362507504614,2607.83,0.0,405963.58,Non-Essential,aastha,2086.26,521.57
774,775,04/03/2023,Movies,True,1390061063265,4610.13,0.0,401353.45,Important,aastha,4610.13,0.0
775,776,05/03/2023,Health,False,1473519623127,0.0,4055.13,405408.58,Essential,aastha,0.0,0.0
776,777,05/03/2023,Books,False,1300328929769,0.0,2060.47,407469.05,Non-important,aastha,0.0,0.0
777,778,05/03/2023,Tools,False,1027286692730,0.0,4364.1,411833.15,Non-important,aastha,0.0,0.0
778,779,05/03/2023,Clothing,False,1062637749652,0.0,1556.02,413389.17,Essential,aastha,0.0,0.0
779,780,05/03/2023,Music,False,1909611428881,0.0,4643.14,418032.31,Non-important,aastha,0.0,0.0
780,781,05/03/2023,Kids,True,1766351145324,1308.48,0.0,416723.83,Non-important,aastha,1243.06,65.42
781,782,05/03/2023,Movies,True,1889296016075,4756.26,0.0,411967.57,Essential,aastha,4280.63,475.63
782,783,05/03/2023,Garden,False,1164103784460,0.0,2852.21,414819.78,Non-Essential,aastha,0.0,0.0
783,784,05/03/2023,Music,True,1753344455912,4630.32,0.0,410189.46,Important,aastha,4630.32,0.0
784,785,05/03/2023,Home,False,1299303614511,0.0,1133.1,411322.56,Essential,aastha,0.0,0.0
785,786,06/03/2023,Grocery,True,1771255814902,3907.59,0.0,407414.97,Important,aastha,3907.59,0.0
786,787,06/03/2023,Shoes,False,1346881108094,0.0,4388.97,411803.94,Important,aastha,0.0,0.0
787,788,06/03/2023,Jewelry,True,1675192526000,1373.21,0.0,410430.73,Important,aastha,1373.21,0.0
788,789,06/03/2023,Music,False,1589314123502,0.0,1600.08,412030.81,Essential,aastha,0.0,0.0
789,790,06/03/2023,Electronics,True,1269745753383,3866.12,0.0,408164.69,Non-important,aastha,3672.81,193.31
790,791,06/03/2023,Grocery,True,1671211407073,3063.66,0.0,405101.03,Important,aastha,3063.66,0.0
791,792,06/03/2023,Electronics,False,1816780715512,0.0,2284.47,407385.5,Non-important,aastha,0.0,0.0
792,793,06/03/2023,Outdoors,False,1220873207769,0.0,392.73,407778.23,Non-Essential,aastha,0.0,0.0
793,794,06/03/2023,Health,False,1680695828068,0.0,2552.24,410330.47,Important,aastha,0.0,0.0
794,795,06/03/2023,Baby,False,1773415475385,0.0,4722.48,415052.95,Important,aastha,0.0,0.0
795,796,07/03/2023,Books,True,1949473251044,3347.28,0.0,411705.67,Non-Essential,aastha,2677.82,669.46
796,797,07/03/2023,Jewelry,False,1708017053537,0.0,1463.84,413169.51,Non-important,aastha,0.0,0.0
797,798,07/03/2023,Books,True,1678859014458,2093.34,0.0,411076.17,Essential,aastha,1884.01,209.33
798,799,07/03/2023,Computers,True,1721621420821,868.84,0.0,410207.33,Non-important,aastha,825.4,43.44
799,800,07/03/2023,Toys,False,1955623912804,0.0,547.44,410754.77,Non-important,aastha,0.0,0.0
800,801,07/03/2023,Health,True,1081241277511,1723.98,0.0,409030.79,Important,aastha,1723.98,0.0
801,802,07/03/2023,Clothing,False,1228420516587,0.0,362.84,409393.63,Important,aastha,0.0,0.0
802,803,07/03/2023,Kids,False,1831080679876,0.0,881.35,410274.98,Important,aastha,0.0,0.0
803,804,07/03/2023,Music,True,1163763122881,4384.88,0.0,405890.1,Non-important,aastha,4165.64,219.24
804,805,08/03/2023,Music,False,1644503921131,0.0,212.09,406102.19,Non-important,aastha,0.0,0.0
805,806,08/03/2023,Music,True,1841379650626,3694.85,0.0,402407.34,Important,aastha,3694.85,0.0
806,807,08/03/2023,Computers,False,1008637973643,0.0,2922.79,405330.13,Important,aastha,0.0,0.0
807,808,08/03/2023,Sports,False,1060770560701,0.0,4804.75,410134.88,Non-important,aastha,0.0,0.0
808,809,08/03/2023,Kids,False,1834864949793,0.0,3713.76,413848.64,Non-important,aastha,0.0,0.0
809,810,08/03/2023,Automotive,True,1502436333660,3926.77,0.0,409921.87,Important,aastha,3926.77,0.0
810,811,08/03/2023,Tools,True,1288283382818,648.83,0.0,409273.04,Important,aastha,648.83,0.0
811,812,08/03/2023,Jewelry,False,1120751038562,0.0,1384.93,410657.97,Non-Essential,aastha,0.0,0.0
812,813,09/03/2023,Toys,False,1806674188661,0.0,2774.78,413432.75,Important,aastha,0.0,0.0
813,814,09/03/2023,Computers,False,1790228611334,0.0,2336.98,415769.73,Important,aastha,0.0,0.0
814,815,09/03/2023,Clothing,True,1491742764440,614.88,0.0,415154.85,Non-Essential,aastha,491.9,122.98
815,816,09/03/2023,Sports,True,1320581108405,3456.86,0.0,411697.99,Non-Essential,aastha,2765.49,691.37
816,817,09/03/2023,Sports,True,1214994014647,844.02,0.0,410853.97,Non-Essential,aastha,675.22,168.8
817,818,09/03/2023,Kids,False,1695863816346,0.0,4107.73,414961.7,Essential,aastha,0.0,0.0
818,819,09/03/2023,Home,True,1701202507794,4677.19,0.0,410284.51,Non-important,aastha,4443.33,233.86
819,820,09/03/2023,Home,False,1178039563796,0.0,3240.15,413524.66,Essential,aastha,0.0,0.0
820,821,09/03/2023,Beauty,False,1019891261173,0.0,2334.73,415859.39,Essential,aastha,0.0,0.0
821,822,09/03/2023,Games,False,1149351529215,0.0,4806.14,420665.53,Important,aastha,0.0,0.0
822,823,10/03/2023,Industrial,False,1029002541035,0.0,1770.87,422436.4,Non-Essential,aastha,0.0,0.0
823,824,10/03/2023,Music,True,1315649653008,4218.5,0.0,418217.9,Non-Essential,aastha,3374.8,843.7
824,825,10/03/2023,Baby,True,1442467901080,3995.31,0.0,414222.59,Non-important,aastha,3795.54,199.77
825,826,10/03/2023,Home,True,1368579413654,1723.73,0.0,412498.86,Non-Essential,aastha,1378.98,344.75
826,827,10/03/2023,Beauty,False,1885852772580,0.0,3275.86,415774.72,Essential,aastha,0.0,0.0
827,828,10/03/2023,Kids,False,1519774674372,0.0,3080.64,418855.36,Important,aastha,0.0,0.0
828,829,10/03/2023,Books,True,1674606194049,2222.19,0.0,416633.17,Essential,aastha,1999.97,222.22
829,830,10/03/2023,Jewelry,False,1930612133330,0.0,3582.55,420215.72,Essential,aastha,0.0,0.0
830,831,10/03/2023,Kids,False,1761522144614,0.0,2643.34,422859.06,Non-important,aastha,0.0,0.0
831,832,10/03/2023,Home,False,1588901833017,0.0,42.33,422901.39,Non-Essential,aastha,0.0,0.0
832,833,11/03/2023,Games,True,1900597126943,943.46,0.0,421957.93,Non-important,aastha,896.29,47.17
833,834,11/03/2023,Industrial,True,1645574770495,4107.43,0.0,417850.5,Non-Essential,aastha,3285.94,821.49
834,835,11/03/2023,Music,True,1127727795980,1587.15,0.0,416263.35,Essential,aastha,1428.43,158.72
835,836,11/03/2023,Computers,False,1224936651942,0.0,3318.79,419582.14,Essential,aastha,0.0,0.0
836,837,11/03/2023,Movies,False,1480358221374,0.0,1782.53,421364.67,Non-Essential,aastha,0.0,0.0
837,838,11/03/2023,Sports,False,1998751362906,0.0,100.84,421465.51,Non-Essential,aastha,0.0,0.0
838,839,11/03/2023,Automotive,True,1199791419681,1216.85,0.0,420248.66,Non-important,aastha,1156.01,60.84
839,840,11/03/2023,Clothing,True,1829775123506,1183.35,0.0,419065.31,Important,aastha,1183.35,0.0
840,841,12/03/2023,Automotive,False,1677828905394,0.0,3696.29,422761.6,Important,aastha,0.0,0.0
841,842,12/03/2023,Kids,False,1774149723368,0.0,2065.92,424827.52,Important,aastha,0.0,0.0
842,843,12/03/2023,Clothing,False,1231430640025,0.0,2887.04,427714.56,Essential,aastha,0.0,0.0
843,844,12/03/2023,Computers,False,1502296512196,0.0,3284.43,430998.99,Essential,aastha,0.0,0.0
844,845,12/03/2023,Grocery,True,1365416774716,4630.88,0.0,426368.11,Non-Essential,aastha,3704.7,926.18
845,846,12/03/2023,Grocery,True,1817355762596,3525.51,0.0,422842.6,Non-important,aastha,3349.23,176.28
846,847,12/03/2023,Kids,False,1719358826395,0.0,386.53,423229.13,Non-Essential,aastha,0.0,0.0
847,848,12/03/2023,Shoes,False,1561779096285,0.0,4982.38,428211.51,Non-Essential,aastha,0.0,0.0
848,849,12/03/2023,Garden,False,1275202523823,0.0,1320.05,429531.56,Non-Essential,aastha,0.0,0.0
849,850,12/03/2023,Kids,False,1850219245511,0.0,1473.71,431005.27,Non-Essential,aastha,0.0,0.0
850,851,12/03/2023,Jewelry,True,1064616505975,959.62,0.0,430045.65,Important,aastha,959.62,0.0
851,852,13/03/2023,Electronics,False,1830503233106,0.0,4906.85,434952.5,Non-Essential,aastha,0.0,0.0
852,853,13/03/2023,Electronics,True,1612967036441,2231.47,0.0,432721.03,Important,aastha,2231.47,0.0
853,854,13/03/2023,Kids,False,1731281312696,0.0,3147.62,435868.65,Important,aastha,0.0,0.0
854,855,13/03/2023,Kids,False,1585253653346,0.0,108.43,435977.08,Non-important,aastha,0.0,0.0
855,856,13/03/2023,Baby,True,1980645130572,2915.09,0.0,433061.99,Non-important,aastha,2769.34,145.75
856,857,13/03/2023,Jewelry,True,1425786290720,4721.61,0.0,428340.38,Important,aastha,4721.61,0.0
857,858,13/03/2023,Automotive,True,1049210944900,2968.44,0.0,425371.94,Important,aastha,2968.44,0.0
858,859,13/03/2023,Electronics,True,1384736026620,2645.32,0.0,422726.62,Essential,aastha,2380.79,264.53
859,860,13/03/2023,Health,False,1006894940512,0.0,1465.2,424191.82,Non-important,aastha,0.0,0.0
860,861,14/03/2023,Outdoors,True,1603712519864,3001.6,0.0,421190.22,Non-important,aastha,2851.52,150.08
861,862,14/03/2023,Industrial,True,1421601150602,3082.33,0.0,418107.89,Non-Essential,aastha,2465.86,616.47
862,863,14/03/2023,Books,False,1275422608735,0.0,2164.49,420272.38,Important,aastha,0.0,0.0
863,864,14/03/2023,Clothing,False,1350559335392,0.0,1520.91,421793.29,Important,aastha,0.0,0.0
864,865,14/03/2023,Tools,False,1209940397167,0.0,1752.73,423546.02,Non-Essential,aastha,0.0,0.0
865,866,14/03/2023,Movies,False,1336651593773,0.0,781.5,424327.52,Important,aastha,0.0,0.0
866,867,14/03/2023,Automotive,True,1889759370679,3564.22,0.0,420763.3,Non-important,aastha,3386.01,178.21
867,868,14/03/2023,Garden,True,1128955551958,1752.33,0.0,419010.97,Non-Essential,aastha,1401.86,350.47
868,869,14/03/2023,Automotive,False,1530779596331,0.0,1158.54,420169.51,Non-Essential,aastha,0.0,0.0
869,870,14/03/2023,Industrial,True,1759549335278,2475.69,0.0,417693.82,Non-important,aastha,2351.91,123.78
870,871,14/03/2023,Outdoors,False,1566070118422,0.0,3120.24,420814.06,Important,aastha,0.0,0.0
871,872,14/03/2023,Outdoors,False,1341820502501,0.0,1543.35,422357.41,Essential,aastha,0.0,0.0
872,873,14/03/2023,Books,False,1757357190614,0.0,4681.64,427039.05,Important,aastha,0.0,0.0
873,874,14/03/2023,Electronics,False,1184239944104,0.0,2141.18,429180.23,Non-Essential,aastha,0.0,0.0
874,875,14/03/2023,Automotive,True,1652966748799,1070.7,0.0,428109.53,Important,aastha,1070.7,0.0
875,876,14/03/2023,Shoes,False,1303135008041,0.0,2921.6,431031.13,Important,aastha,0.0,0.0
876,877,14/03/2023,Movies,True,1622263787652,2956.03,0.0,428075.1,Non-Essential,aastha,2364.82,591.21
877,878,15/03/2023,Shoes,False,1057293429695,0.0,2067.46,430142.56,Essential,aastha,0.0,0.0
878,879,15/03/2023,Sports,True,1789386235132,716.52,0.0,429426.04,Non-important,aastha,680.69,35.83
879,880,15/03/2023,Electronics,True,1858656297833,1487.92,0.0,427938.12,Non-Essential,aastha,1190.34,297.58
880,881,15/03/2023,Baby,False,1140461896097,0.0,2903.71,430841.83,Important,aastha,0.0,0.0
881,882,15/03/2023,Garden,False,1122953386702,0.0,2796.29,433638.12,Essential,aastha,0.0,0.0
882,883,15/03/2023,Music,True,1364314063166,2536.82,0.0,431101.3,Important,aastha,2536.82,0.0
883,884,15/03/2023,Books,False,1872147941200,0.0,4784.89,435886.19,Important,aastha,0.0,0.0
884,885,15/03/2023,Jewelry,True,1185061282243,786.85,0.0,435099.34,Essential,aastha,708.16,78.69
885,886,15/03/2023,Industrial,True,1994434287380,2980.82,0.0,432118.52,Essential,aastha,2682.74,298.08
886,887,15/03/2023,Grocery,False,1857576131439,0.0,4365.8,436484.32,Important,aastha,0.0,0.0
887,888,15/03/2023,Toys,True,1995419083614,986.99,0.0,435497.33,Essential,aastha,888.29,98.7
888,889,15/03/2023,Industrial,False,1607202539764,0.0,3380.04,438877.37,Non-Essential,aastha,0.0,0.0
889,890,15/03/2023,Industrial,True,1798345282965,1648.97,0.0,437228.4,Non-important,aastha,1566.52,82.45
890,891,15/03/2023,Home,False,1484118145589,0.0,3311.79,440540.19,Essential,aastha,0.0,0.0
891,892,15/03/2023,Movies,False,1763364476446,0.0,4717.5,445257.69,Non-Essential,aastha,0.0,0.0
892,893,16/03/2023,Kids,True,1847679156439,742.44,0.0,444515.25,Non-Essential,aastha,593.95,148.49
893,894,16/03/2023,Baby,False,1976952526541,0.0,1076.77,445592.02,Non-Essential,aastha,0.0,0.0
894,895,16/03/2023,Music,True,1933670123391,1278.11,0.0,444313.91,Non-important,aastha,1214.2,63.91
895,896,16/03/2023,Shoes,True,1880521661293,4196.36,0.0,440117.55,Important,aastha,4196.36,0.0
896,897,16/03/2023,Outdoors,False,1047933291566,0.0,3418.33,443535.88,Essential,aastha,0.0,0.0
897,898,16/03/2023,Baby,False,1444715332538,0.0,4154.22,447690.1,Non-important,aastha,0.0,0.0
898,899,16/03/2023,Electronics,False,1844755778616,0.0,1584.76,449274.86,Essential,aastha,0.0,0.0
899,900,16/03/2023,Music,False,1809938417506,0.0,2147.53,451422.39,Non-important,aastha,0.0,0.0
900,901,16/03/2023,Grocery,True,1551023239673,4089.02,0.0,447333.37,Essential,aastha,3680.12,408.9
901,902,16/03/2023,Movies,True,1199226680477,2071.03,0.0,445262.34,Non-Essential,aastha,1656.82,414.21
902,903,16/03/2023,Books,True,1274774726316,2557.71,0.0,442704.63,Non-Essential,aastha,2046.17,511.54
903,904,16/03/2023,Toys,False,1739145098382,0.0,3906.55,446611.18,Important,aastha,0.0,0.0
904,905,17/03/2023,Automotive,True,1381070879468,1301.15,0.0,445310.03,Essential,aastha,1171.04,130.12
905,906,17/03/2023,Books,False,1205289515201,0.0,2546.77,447856.8,Essential,aastha,0.0,0.0
906,907,17/03/2023,Garden,True,1348977445683,4731.6,0.0,443125.2,Important,aastha,4731.6,0.0
907,908,17/03/2023,Shoes,True,1527974316022,1975.99,0.0,441149.21,Important,aastha,1975.99,0.0
908,909,17/03/2023,Kids,False,1379062542240,0.0,2000.52,443149.73,Important,aastha,0.0,0.0
909,910,17/03/2023,Baby,True,1599944415046,171.19,0.0,442978.54,Non-Essential,aastha,136.95,34.24
910,911,17/03/2023,Baby,True,1573255711418,1185.36,0.0,441793.18,Important,aastha,1185.36,0.0
911,912,17/03/2023,Movies,False,1554935523296,0.0,1786.49,443579.67,Important,aastha,0.0,0.0
912,913,17/03/2023,Industrial,False,1120465372432,0.0,2413.0,445992.67,Essential,aastha,0.0,0.0
913,914,17/03/2023,Health,True,1526564927426,1536.64,0.0,444456.03,Essential,aastha,1382.98,153.66
914,915,18/03/2023,Outdoors,True,1913774363341,3865.54,0.0,440590.49,Essential,aastha,3478.99,386.55
915,916,18/03/2023,Electronics,True,1257407841397,1647.24,0.0,438943.25,Non-important,aastha,1564.88,82.36
916,917,18/03/2023,Toys,False,1920981390374,0.0,2231.98,441175.23,Non-important,aastha,0.0,0.0
917,918,18/03/2023,Tools,True,1126663220713,2289.97,0.0,438885.26,Non-important,aastha,2175.47,114.5
918,919,18/03/2023,Jewelry,True,1657703062764,4645.8,0.0,434239.46,Non-Essential,aastha,3716.64,929.16
919,920,18/03/2023,Toys,True,1838671357209,2136.54,0.0,432102.92,Non-Essential,aastha,1709.23,427.31
920,921,18/03/2023,Electronics,True,1212116826282,3135.87,0.0,428967.05,Non-important,aastha,2979.08,156.79
921,922,18/03/2023,Jewelry,True,1181672247021,2970.46,0.0,425996.59,Non-Essential,aastha,2376.37,594.09
922,923,18/03/2023,Home,False,1670055218767,0.0,3214.46,429211.05,Non-important,aastha,0.0,0.0
923,924,18/03/2023,Baby,False,1626829190498,0.0,864.74,430075.79,Non-important,aastha,0.0,0.0
924,925,19/03/2023,Toys,False,1653547296981,0.0,841.21,430917.0,Essential,aastha,0.0,0.0
925,926,19/03/2023,Books,True,1492501766957,1444.93,0.0,429472.07,Essential,aastha,1300.44,144.49
926,927,19/03/2023,Computers,True,1615666997116,458.36,0.0,429013.71,Non-Essential,aastha,366.69,91.67
927,928,19/03/2023,Beauty,True,1087829189054,3508.5,0.0,425505.21,Non-important,aastha,3333.07,175.43
928,929,19/03/2023,Books,True,1707165124439,2900.81,0.0,422604.4,Important,aastha,2900.81,0.0
929,930,19/03/2023,Beauty,True,1944172968393,3233.39,0.0,419371.01,Important,aastha,3233.39,0.0
930,931,19/03/2023,Health,False,1626718886885,0.0,3129.25,422500.26,Essential,aastha,0.0,0.0
931,932,19/03/2023,Jewelry,False,1237662943801,0.0,9.4,422509.66,Non-important,aastha,0.0,0.0
932,933,19/03/2023,Sports,False,1826398486725,0.0,3414.32,425923.98,Non-important,aastha,0.0,0.0
933,934,19/03/2023,Games,True,1906617869448,3651.09,0.0,422272.89,Non-Essential,aastha,2920.87,730.22
934,935,19/03/2023,Music,False,1507558506018,0.0,1067.76,423340.65,Essential,aastha,0.0,0.0
935,936,19/03/2023,Shoes,False,1241358639742,0.0,1476.93,424817.58,Non-Essential,aastha,0.0,0.0
936,937,19/03/2023,Clothing,False,1447946946487,0.0,3714.9,428532.48,Non-Essential,aastha,0.0,0.0
937,938,19/03/2023,Garden,True,1590642716621,257.7,0.0,428274.78,Non-important,aastha,244.81,12.88
938,939,20/03/2023,Sports,True,1730799428317,2990.39,0.0,425284.39,Essential,aastha,2691.35,299.04
939,940,20/03/2023,Baby,True,1637962889448,3936.86,0.0,421347.53,Non-important,aastha,3740.02,196.84
940,941,20/03/2023,Outdoors,False,1429823545603,0.0,3492.99,424840.52,Important,aastha,0.0,0.0
941,942,20/03/2023,Toys,False,1342065889201,0.0,2491.85,427332.37,Essential,aastha,0.0,0.0
942,943,20/03/2023,Industrial,False,1180887023390,0.0,2466.58,429798.95,Essential,aastha,0.0,0.0
943,944,20/03/2023,Sports,True,1423667198953,4630.8,0.0,425168.15,Non-important,aastha,4399.26,231.54
944,945,20/03/2023,Sports,False,1297089097194,0.0,3683.47,428851.62,Essential,aastha,0.0,0.0
945,946,20/03/2023,Health,False,1682801240111,0.0,316.94,429168.56,Non-important,aastha,0.0,0.0
946,947,21/03/2023,Grocery,True,1147898932287,2304.97,0.0,426863.59,Non-Essential,aastha,1843.98,460.99
947,948,21/03/2023,Grocery,True,1022796347531,1492.0,0.0,425371.59,Essential,aastha,1342.8,149.2
948,949,21/03/2023,Tools,False,1139583131209,0.0,3226.05,428597.64,Important,aastha,0.0,0.0
949,950,21/03/2023,Toys,True,1138627095349,4701.44,0.0,423896.2,Essential,aastha,4231.3,470.14
950,951,21/03/2023,Toys,False,1161656589051,0.0,4427.12,428323.32,Non-Essential,aastha,0.0,0.0
951,952,21/03/2023,Clothing,True,1335848058843,2136.85,0.0,426186.47,Important,aastha,2136.85,0.0
952,953,21/03/2023,Books,False,1552424670940,0.0,756.6,426943.07,Essential,aastha,0.0,0.0
953,954,21/03/2023,Games,False,1770408761855,0.0,2842.87,429785.94,Non-important,aastha,0.0,0.0
954,955,21/03/2023,Baby,False,1071242911317,0.0,950.2,430736.14,Essential,aastha,0.0,0.0
955,956,21/03/2023,Garden,True,1381661297861,1524.97,0.0,429211.17,Essential,aastha,1372.47,152.5
956,957,21/03/2023,Garden,False,1792133260871,0.0,621.08,429832.25,Non-Essential,aastha,0.0,0.0
957,958,21/03/2023,Kids,False,1493681583130,0.0,4622.82,434455.07,Non-important,aastha,0.0,0.0
958,959,22/03/2023,Health,False,1518881381046,0.0,1443.58,435898.65,Non-important,aastha,0.0,0.0
959,960,22/03/2023,Movies,True,1679145416972,4090.62,0.0,431808.03,Non-important,aastha,3886.09,204.53
960,961,22/03/2023,Sports,False,1346101789559,0.0,992.24,432800.27,Essential,aastha,0.0,0.0
961,962,22/03/2023,Garden,True,1357196450321,2425.5,0.0,430374.77,Important,aastha,2425.5,0.0
962,963,22/03/2023,Industrial,True,1139357105140,2260.56,0.0,428114.21,Essential,aastha,2034.5,226.06
963,964,22/03/2023,Garden,True,1633643165772,639.73,0.0,427474.48,Essential,aastha,575.76,63.97
964,965,22/03/2023,Games,True,1559719493583,3030.23,0.0,424444.25,Essential,aastha,2727.21,303.02
965,966,22/03/2023,Jewelry,False,1311827011613,0.0,1924.52,426368.77,Non-important,aastha,0.0,0.0
966,967,22/03/2023,Jewelry,True,1464908181835,3004.09,0.0,423364.68,Non-important,aastha,2853.89,150.2
967,968,23/03/2023,Beauty,False,1303840694188,0.0,4301.2,427665.88,Important,aastha,0.0,0.0
968,969,23/03/2023,Home,True,1127655698258,3748.73,0.0,423917.15,Non-Essential,aastha,2998.98,749.75
969,970,23/03/2023,Toys,False,1400101981226,0.0,4180.85,428098.0,Essential,aastha,0.0,0.0
970,971,23/03/2023,Toys,True,1067540367738,912.39,0.0,427185.61,Non-Essential,aastha,729.91,182.48
971,972,23/03/2023,Garden,False,1929273850400,0.0,3705.75,430891.36,Non-Essential,aastha,0.0,0.0
972,973,23/03/2023,Games,False,1651626139231,0.0,4338.51,435229.87,Non-important,aastha,0.0,0.0
973,974,23/03/2023,Movies,True,1921561310833,2756.59,0.0,432473.28,Important,aastha,2756.59,0.0
974,975,23/03/2023,Clothing,True,1115885426858,4506.62,0.0,427966.66,Non-Essential,aastha,3605.3,901.32
975,976,23/03/2023,Baby,True,1934106846510,3601.29,0.0,424365.37,Non-important,aastha,3421.23,180.06
976,977,23/03/2023,Grocery,False,1596094898986,0.0,3083.24,427448.61,Non-Essential,aastha,0.0,0.0
977,978,23/03/2023,Movies,False,1457217968339,0.0,4616.47,432065.08,Non-important,aastha,0.0,0.0
978,979,23/03/2023,Home,True,1833564491382,2089.35,0.0,429975.73,Non-important,aastha,1984.88,104.47
979,980,23/03/2023,Books,True,1772310626802,926.18,0.0,429049.55,Important,aastha,926.18,0.0
980,981,23/03/2023,Beauty,True,1174960774489,311.53,0.0,428738.02,Non-important,aastha,295.95,15.58
981,982,23/03/2023,Baby,True,1248777715674,4268.41,0.0,424469.61,Important,aastha,4268.41,0.0
982,983,23/03/2023,Games,False,1637201447560,0.0,2564.42,427034.03,Important,aastha,0.0,0.0
983,984,23/03/2023,Music,False,1539262875919,0.0,4995.88,432029.91,Non-Essential,aastha,0.0,0.0
984,985,23/03/2023,Baby,True,1389612763116,1585.0,0.0,430444.91,Essential,aastha,1426.5,158.5
985,986,23/03/2023,Music,True,1938876533555,131.97,0.0,430312.94,Non-important,aastha,125.37,6.6
986,987,23/03/2023,Health,False,1113878418769,0.0,441.28,430754.22,Non-Essential,aastha,0.0,0.0
987,988,23/03/2023,Movies,True,1182199366818,1071.75,0.0,429682.47,Non-Essential,aastha,857.4,214.35
988,989,24/03/2023,Toys,False,1165796633461,0.0,4022.85,433705.32,Essential,aastha,0.0,0.0
989,990,24/03/2023,Garden,False,1639344010641,0.0,1017.32,434722.64,Important,aastha,0.0,0.0
990,991,24/03/2023,Grocery,True,1261439933863,4046.9,0.0,430675.74,Non-important,aastha,3844.56,202.35
991,992,24/03/2023,Toys,False,1516111446345,0.0,2211.02,432886.76,Important,aastha,0.0,0.0
992,993,24/03/2023,Tools,False,1065409869215,0.0,511.67,433398.43,Essential,aastha,0.0,0.0
993,994,24/03/2023,Health,False,1454388201224,0.0,897.51,434295.94,Non-Essential,aastha,0.0,0.0
994,995,24/03/2023,Computers,True,1925279743432,4187.3,0.0,430108.64,Non-important,aastha,3977.94,209.37
995,996,24/03/2023,Automotive,True,1383760846113,3989.5,0.0,426119.14,Essential,aastha,3590.55,398.95
996,997,24/03/2023,Automotive,False,1687810536590,0.0,1487.0,427606.14,Non-important,aastha,0.0,0.0
997,998,24/03/2023,Books,False,1777952452267,0.0,4530.56,432136.7,Important,aastha,0.0,0.0
998,999,24/03/2023,Garden,True,1013777706410,3998.85,0.0,428137.85,Non-important,aastha,3798.91,199.94
999,1000,24/03/2023,Sports,False,1080334692591,0.0,1528.4,429666.25,Important,aastha,0.0,0.0
