,row,Txn Date,Description,Transfer To/From,Ref No./Cheque No.,Debit,Credit,Balance,Class,User
0,1,23/12/2022,Toys,False,2235056301457,0.0,1453.89,540283.71,Important,pranjal
1,2,23/12/2022,Clothing,False,2153874362292,0.0,1995.38,542279.09,Essential,pranjal
2,3,23/12/2022,Industrial,True,2156143492489,2899.33,0.0,539379.76,Important,pranjal
3,4,23/12/2022,Games,False,2003697616024,0.0,1532.03,540911.79,Non-Essential,pranjal
4,5,23/12/2022,Clothing,True,2086344215661,2355.73,0.0,538556.06,Non-Essential,pranjal
5,6,23/12/2022,Music,True,2490790716171,1973.11,0.0,536582.95,Essential,pranjal
6,7,23/12/2022,Outdoors,True,2149767778002,2604.32,0.0,533978.63,Important,pranjal
7,8,23/12/2022,Grocery,True,2016170275768,2910.13,0.0,531068.5,Essential,pranjal
8,9,23/12/2022,Grocery,False,2096494119394,0.0,1794.64,532863.14,Non-Essential,pranjal
9,10,23/12/2022,Health,False,2717243753532,0.0,2805.57,535668.71,Important,pranjal
10,11,23/12/2022,Home,True,2694610074296,1295.42,0.0,534373.29,Essential,pranjal
11,12,23/12/2022,Toys,True,2917605618306,1727.37,0.0,532645.92,Non-Essential,pranjal
12,13,23/12/2022,Computers,False,2279594515245,0.0,2885.79,535531.71,Essential,pranjal
13,14,23/12/2022,Beauty,False,2742918496447,0.0,2915.08,538446.79,Non-Essential,pranjal
14,15,24/12/2022,Clothing,False,2153385917337,0.0,1948.11,540394.9,Non-Essential,pranjal
15,16,24/12/2022,Grocery,True,2648207424484,1613.02,0.0,538781.88,Essential,pranjal
16,17,24/12/2022,Books,True,2558846261879,2146.17,0.0,536635.71,Essential,pranjal
17,18,24/12/2022,Baby,False,2222389139458,0.0,1622.53,538258.24,Essential,pranjal
18,19,24/12/2022,Toys,False,2386456912918,0.0,748.71,539006.95,Non-Essential,pranjal
19,20,24/12/2022,Baby,True,2584315428394,1180.67,0.0,537826.28,Important,pranjal
20,21,24/12/2022,Music,False,2637505662152,0.0,1477.54,539303.82,Non-important,pranjal
21,22,24/12/2022,Grocery,True,2779153463911,1587.59,0.0,537716.23,Essential,pranjal
22,23,24/12/2022,Baby,True,2398953270555,2476.84,0.0,535239.39,Essential,pranjal
23,24,24/12/2022,Computers,False,2656977692993,0.0,2428.52,537667.91,Non-important,pranjal
24,25,25/12/2022,Beauty,True,2675891621283,2223.2,0.0,535444.71,Non-Essential,pranjal
25,26,25/12/2022,Computers,True,2347662982315,2767.17,0.0,532677.54,Essential,pranjal
26,27,25/12/2022,Clothing,False,2723733264201,0.0,487.94,533165.48,Essential,pranjal
27,28,25/12/2022,Home,False,2759497587783,0.0,382.86,533548.34,Non-Essential,pranjal
28,29,25/12/2022,Grocery,True,2796192848605,1151.53,0.0,532396.81,Non-Essential,pranjal
29,30,25/12/2022,Garden,False,2697398488022,0.0,1887.36,534284.17,Non-important,pranjal
30,31,25/12/2022,Games,False,2559095109473,0.0,2403.64,536687.81,Non-important,pranjal
31,32,25/12/2022,Shoes,True,2039437836194,125.23,0.0,536562.58,Important,pranjal
32,33,25/12/2022,Sports,False,2568479729707,0.0,2700.39,539262.97,Important,pranjal
33,34,26/12/2022,Electronics,True,2610760950233,86.92,0.0,539176.05,Non-Essential,pranjal
34,35,26/12/2022,Health,False,2886527654271,0.0,1319.34,540495.39,Essential,pranjal
35,36,26/12/2022,Movies,True,2509912587299,1321.12,0.0,539174.27,Important,pranjal
36,37,26/12/2022,Toys,True,2808436303656,2364.75,0.0,536809.52,Important,pranjal
37,38,26/12/2022,Toys,False,2070118238933,0.0,1921.05,538730.57,Non-important,pranjal
38,39,26/12/2022,Garden,True,2483572388693,1505.67,0.0,537224.9,Non-important,pranjal
39,40,26/12/2022,Books,False,2869495816434,0.0,2324.52,539549.42,Non-Essential,pranjal
40,41,26/12/2022,Toys,True,2986692250060,638.94,0.0,538910.48,Important,pranjal
41,42,26/12/2022,Health,False,2042894788070,0.0,2875.25,541785.73,Non-important,pranjal
42,43,26/12/2022,Shoes,False,2912935671461,0.0,738.51,542524.24,Important,pranjal
43,44,26/12/2022,Electronics,False,2622860734042,0.0,18.57,542542.81,Important,pranjal
44,45,26/12/2022,Books,False,2584896885126,0.0,2726.27,545269.08,Important,pranjal
45,46,26/12/2022,Garden,True,2070663660643,2474.66,0.0,542794.42,Essential,pranjal
46,47,27/12/2022,Shoes,False,2308507398134,0.0,10.25,542804.67,Important,pranjal
47,48,27/12/2022,Tools,True,2208908283863,1794.02,0.0,541010.65,Essential,pranjal
48,49,27/12/2022,Home,False,2907892820442,0.0,559.44,541570.09,Non-important,pranjal
49,50,27/12/2022,Electronics,False,2866190384328,0.0,2839.41,544409.5,Important,pranjal
50,51,27/12/2022,Toys,True,2614794895056,2169.98,0.0,542239.52,Essential,pranjal
51,52,27/12/2022,Automotive,False,2369418564620,0.0,646.47,542885.99,Non-Essential,pranjal
52,53,27/12/2022,Beauty,True,2522503055785,592.78,0.0,542293.21,Non-Essential,pranjal
53,54,27/12/2022,Movies,False,2235552669844,0.0,471.87,542765.08,Important,pranjal
54,55,27/12/2022,Health,True,2017935401247,736.61,0.0,542028.47,Non-Essential,pranjal
55,56,27/12/2022,Computers,True,2618595427030,675.7,0.0,541352.77,Non-important,pranjal
56,57,27/12/2022,Sports,True,2253800934074,965.63,0.0,540387.14,Essential,pranjal
57,58,28/12/2022,Home,False,2914900616635,0.0,2554.39,542941.53,Non-important,pranjal
58,59,28/12/2022,Shoes,False,2677750833801,0.0,923.28,543864.81,Non-Essential,pranjal
59,60,28/12/2022,Health,False,2231310571669,0.0,2672.48,546537.29,Non-Essential,pranjal
60,61,28/12/2022,Grocery,False,2018591525739,0.0,1306.3,547843.59,Important,pranjal
61,62,28/12/2022,Movies,True,2750835063783,2345.12,0.0,545498.47,Essential,pranjal
62,63,28/12/2022,Clothing,True,2810558129222,1505.93,0.0,543992.54,Non-important,pranjal
63,64,29/12/2022,Baby,False,2850816627496,0.0,2460.17,546452.71,Non-Essential,pranjal
64,65,29/12/2022,Health,False,2199043954834,0.0,1267.48,547720.19,Non-important,pranjal
65,66,29/12/2022,Home,True,2007183525733,677.06,0.0,547043.13,Non-important,pranjal
66,67,29/12/2022,Home,True,2768898532731,2482.76,0.0,544560.37,Important,pranjal
67,68,29/12/2022,Health,False,2551979387326,0.0,818.03,545378.4,Non-Essential,pranjal
68,69,29/12/2022,Toys,False,2088811338733,0.0,1301.44,546679.84,Important,pranjal
69,70,29/12/2022,Garden,True,2938576078295,1948.57,0.0,544731.27,Essential,pranjal
70,71,29/12/2022,Kids,True,2725578942031,2493.59,0.0,542237.68,Important,pranjal
71,72,29/12/2022,Clothing,True,2194398294120,1080.01,0.0,541157.67,Non-important,pranjal
72,73,29/12/2022,Industrial,True,2302051675327,127.46,0.0,541030.21,Non-Essential,pranjal
73,74,29/12/2022,Games,False,2286952453506,0.0,2406.46,543436.67,Non-Essential,pranjal
74,75,29/12/2022,Outdoors,False,2444827418995,0.0,1202.67,544639.34,Non-important,pranjal
75,76,29/12/2022,Jewelry,True,2769666419844,813.49,0.0,543825.85,Non-important,pranjal
76,77,30/12/2022,Movies,False,2213109215151,0.0,184.8,544010.65,Important,pranjal
77,78,30/12/2022,Baby,True,2786517079270,308.81,0.0,543701.84,Essential,pranjal
78,79,30/12/2022,Industrial,True,2763364784505,2541.52,0.0,541160.32,Important,pranjal
79,80,30/12/2022,Home,False,2782374489949,0.0,1359.82,542520.14,Non-Essential,pranjal
80,81,30/12/2022,Jewelry,False,2395098169918,0.0,142.92,542663.06,Non-important,pranjal
81,82,30/12/2022,Outdoors,True,2717856117365,2170.9,0.0,540492.16,Important,pranjal
82,83,30/12/2022,Books,True,2957542361553,2213.59,0.0,538278.57,Essential,pranjal
83,84,30/12/2022,Electronics,True,2004450361664,93.68,0.0,538184.89,Important,pranjal
84,85,30/12/2022,Shoes,True,2268156019016,206.51,0.0,537978.38,Important,pranjal
85,86,31/12/2022,Health,False,2067908214974,0.0,1123.69,539102.07,Non-Essential,pranjal
86,87,31/12/2022,Grocery,False,2998236209840,0.0,2461.01,541563.08,Non-Essential,pranjal
87,88,31/12/2022,Garden,True,2699881246643,1178.78,0.0,540384.3,Non-Essential,pranjal
88,89,31/12/2022,Books,True,2683615916286,2920.36,0.0,537463.94,Important,pranjal
89,90,31/12/2022,Shoes,False,2699534235305,0.0,1866.31,539330.25,Non-important,pranjal
90,91,31/12/2022,Shoes,True,2114810735360,2700.74,0.0,536629.51,Important,pranjal
91,92,31/12/2022,Grocery,False,2124360884640,0.0,538.51,537168.02,Important,pranjal
92,93,31/12/2022,Outdoors,True,2419869842103,1369.91,0.0,535798.11,Essential,pranjal
93,94,31/12/2022,Home,True,2540706628813,1262.0,0.0,534536.11,Essential,pranjal
94,95,31/12/2022,Baby,True,2529568856065,1147.09,0.0,533389.02,Important,pranjal
95,96,01/01/2023,Music,False,2122470910014,0.0,2633.18,536022.2,Non-Essential,pranjal
96,97,01/01/2023,Movies,False,2385173523650,0.0,718.67,536740.87,Important,pranjal
97,98,01/01/2023,Books,True,2953040093153,111.06,0.0,536629.81,Essential,pranjal
98,99,01/01/2023,Health,False,2109951307027,0.0,2861.79,539491.6,Essential,pranjal
99,100,01/01/2023,Baby,True,2940273492509,2186.9,0.0,537304.7,Non-Essential,pranjal
100,101,02/01/2023,Jewelry,True,2490902050173,2378.78,0.0,534925.92,Important,pranjal
101,102,02/01/2023,Games,False,2609913227848,0.0,1944.01,536869.93,Non-Essential,pranjal
102,103,02/01/2023,Shoes,False,2165529478978,0.0,2599.78,539469.71,Essential,pranjal
103,104,02/01/2023,Automotive,False,2356244898745,0.0,1752.57,541222.28,Non-important,pranjal
104,105,02/01/2023,Industrial,False,2078961940101,0.0,1838.83,543061.11,Non-Essential,pranjal
105,106,02/01/2023,Electronics,True,2654619459318,440.32,0.0,542620.79,Important,pranjal
106,107,02/01/2023,Industrial,True,2158540734758,415.59,0.0,542205.2,Essential,pranjal
107,108,02/01/2023,Tools,False,2667964345738,0.0,2865.56,545070.76,Important,pranjal
108,109,03/01/2023,Home,False,2225362163335,0.0,66.01,545136.77,Important,pranjal
109,110,03/01/2023,Grocery,True,2328163904381,101.7,0.0,545035.07,Non-Essential,pranjal
110,111,03/01/2023,Health,True,2023470964569,1017.98,0.0,544017.09,Essential,pranjal
111,112,03/01/2023,Beauty,False,2759067571998,0.0,2226.92,546244.01,Essential,pranjal
112,113,03/01/2023,Baby,False,2223106605264,0.0,160.49,546404.5,Non-Essential,pranjal
113,114,03/01/2023,Beauty,False,2695972059976,0.0,717.31,547121.81,Important,pranjal
114,115,03/01/2023,Beauty,True,2684143311350,1747.98,0.0,545373.83,Non-important,pranjal
115,116,03/01/2023,Toys,True,2908499800544,1512.61,0.0,543861.22,Non-Essential,pranjal
116,117,03/01/2023,Jewelry,False,2506375717646,0.0,2439.84,546301.06,Important,pranjal
117,118,03/01/2023,Baby,False,2915699734987,0.0,250.42,546551.48,Important,pranjal
118,119,03/01/2023,Sports,False,2670573724638,0.0,2504.16,549055.64,Non-Essential,pranjal
119,120,03/01/2023,Games,False,2731432063634,0.0,850.44,549906.08,Essential,pranjal
120,121,03/01/2023,Home,True,2111990763140,2659.0,0.0,547247.08,Important,pranjal
121,122,03/01/2023,Movies,True,2657951080321,1987.9,0.0,545259.18,Important,pranjal
122,123,03/01/2023,Tools,True,2552907218538,2719.75,0.0,542539.43,Non-Essential,pranjal
123,124,04/01/2023,Beauty,True,2575029662379,97.93,0.0,542441.5,Non-Essential,pranjal
124,125,04/01/2023,Toys,True,2271917905801,2291.5,0.0,540150.0,Non-important,pranjal
125,126,04/01/2023,Kids,False,2970336564539,0.0,1706.25,541856.25,Non-Essential,pranjal
126,127,04/01/2023,Baby,False,2923175726528,0.0,2081.56,543937.81,Non-important,pranjal
127,128,04/01/2023,Jewelry,False,2091743004416,0.0,2397.23,546335.04,Non-important,pranjal
128,129,04/01/2023,Outdoors,True,2299475014337,1937.98,0.0,544397.06,Non-important,pranjal
129,130,04/01/2023,Shoes,True,2416567872957,893.82,0.0,543503.24,Important,pranjal
130,131,04/01/2023,Shoes,True,2104643308263,1400.64,0.0,542102.6,Non-important,pranjal
131,132,04/01/2023,Movies,True,2175599420231,730.54,0.0,541372.06,Essential,pranjal
132,133,04/01/2023,Baby,False,2810147899289,0.0,1475.59,542847.65,Important,pranjal
133,134,04/01/2023,Kids,False,2846602730378,0.0,1336.71,544184.36,Essential,pranjal
134,135,04/01/2023,Beauty,True,2069794118136,1803.73,0.0,542380.63,Non-important,pranjal
135,136,04/01/2023,Grocery,False,2376256231353,0.0,2892.2,545272.83,Essential,pranjal
136,137,04/01/2023,Shoes,True,2514413238599,717.51,0.0,544555.32,Non-Essential,pranjal
137,138,04/01/2023,Kids,True,2095329834298,1390.04,0.0,543165.28,Non-Essential,pranjal
138,139,04/01/2023,Baby,True,2932644255896,2154.36,0.0,541010.92,Essential,pranjal
139,140,04/01/2023,Tools,False,2608205507318,0.0,299.31,541310.23,Essential,pranjal
140,141,04/01/2023,Sports,False,2472284019259,0.0,2779.37,544089.6,Non-Essential,pranjal
141,142,05/01/2023,Grocery,True,2029857073390,2030.08,0.0,542059.52,Non-important,pranjal
142,143,05/01/2023,Tools,True,2051673575868,414.78,0.0,541644.74,Important,pranjal
143,144,05/01/2023,Shoes,True,2266059851349,2751.19,0.0,538893.55,Non-important,pranjal
144,145,05/01/2023,Automotive,True,2412010032754,981.57,0.0,537911.98,Non-important,pranjal
145,146,05/01/2023,Automotive,False,2486880121155,0.0,1311.22,539223.2,Non-Essential,pranjal
146,147,05/01/2023,Health,False,2506929534646,0.0,2218.11,541441.31,Important,pranjal
147,148,05/01/2023,Toys,False,2147184081520,0.0,1236.52,542677.83,Non-Essential,pranjal
148,149,05/01/2023,Shoes,True,2336961671324,1408.44,0.0,541269.39,Non-important,pranjal
149,150,05/01/2023,Music,False,2284441179584,0.0,1052.37,542321.76,Essential,pranjal
150,151,05/01/2023,Games,False,2230031022531,0.0,2826.69,545148.45,Non-Essential,pranjal
151,152,05/01/2023,Tools,True,2003171665185,2194.0,0.0,542954.45,Non-important,pranjal
152,153,05/01/2023,Books,True,2298575100133,1655.17,0.0,541299.28,Non-Essential,pranjal
153,154,05/01/2023,Electronics,True,2025702549875,141.32,0.0,541157.96,Essential,pranjal
154,155,06/01/2023,Jewelry,True,2248446073939,2230.02,0.0,538927.94,Non-important,pranjal
155,156,06/01/2023,Toys,True,2071249907601,1715.89,0.0,537212.05,Non-Essential,pranjal
156,157,06/01/2023,Beauty,True,2247409770600,2810.28,0.0,534401.77,Important,pranjal
157,158,06/01/2023,Baby,True,2206310994358,1895.15,0.0,532506.62,Essential,pranjal
158,159,06/01/2023,Home,False,2256518850740,0.0,2803.29,535309.91,Essential,pranjal
159,160,06/01/2023,Books,True,2216591695091,2376.89,0.0,532933.02,Important,pranjal
160,161,06/01/2023,Shoes,False,2797926326218,0.0,537.89,533470.91,Important,pranjal
161,162,06/01/2023,Sports,False,2028512243366,0.0,334.52,533805.43,Essential,pranjal
162,163,06/01/2023,Home,False,2558990943293,0.0,1840.02,535645.45,Non-important,pranjal
163,164,06/01/2023,Industrial,False,2419373184363,0.0,888.51,536533.96,Non-important,pranjal
164,165,06/01/2023,Music,False,2943841148875,0.0,2763.68,539297.64,Non-important,pranjal
165,166,06/01/2023,Books,True,2961383079846,2329.12,0.0,536968.52,Important,pranjal
166,167,06/01/2023,Industrial,True,2272388766762,2596.46,0.0,534372.06,Essential,pranjal
167,168,07/01/2023,Books,True,2438457453221,1314.04,0.0,533058.02,Non-important,pranjal
168,169,07/01/2023,Shoes,False,2307023033084,0.0,190.68,533248.7,Non-important,pranjal
169,170,07/01/2023,Automotive,False,2832814742243,0.0,2936.84,536185.54,Non-Essential,pranjal
170,171,07/01/2023,Health,False,2563131576123,0.0,2406.62,538592.16,Non-important,pranjal
171,172,07/01/2023,Home,False,2581312179308,0.0,1680.96,540273.12,Essential,pranjal
172,173,07/01/2023,Outdoors,True,2499871180465,1267.47,0.0,539005.65,Important,pranjal
173,174,07/01/2023,Computers,True,2778841784480,897.89,0.0,538107.76,Essential,pranjal
174,175,07/01/2023,Health,False,2988324377148,0.0,2822.14,540929.9,Important,pranjal
175,176,07/01/2023,Games,False,2729021891533,0.0,870.51,541800.41,Non-Essential,pranjal
176,177,07/01/2023,Kids,True,2185671853404,1756.34,0.0,540044.07,Essential,pranjal
177,178,07/01/2023,Movies,True,2891515086980,830.43,0.0,539213.64,Non-important,pranjal
178,179,07/01/2023,Tools,True,2643230183412,1475.07,0.0,537738.57,Non-important,pranjal
179,180,08/01/2023,Toys,True,2412380541457,1228.51,0.0,536510.06,Important,pranjal
180,181,08/01/2023,Baby,True,2509154215480,934.42,0.0,535575.64,Important,pranjal
181,182,08/01/2023,Jewelry,True,2361226166589,2940.62,0.0,532635.02,Non-important,pranjal
182,183,08/01/2023,Games,True,2515359206800,1255.54,0.0,531379.48,Non-Essential,pranjal
183,184,08/01/2023,Books,True,2145998544168,1548.65,0.0,529830.83,Non-Essential,pranjal
184,185,08/01/2023,Automotive,True,2433762221627,2777.9,0.0,527052.93,Non-Essential,pranjal
185,186,08/01/2023,Outdoors,True,2337261825665,1772.92,0.0,525280.01,Non-Essential,pranjal
186,187,08/01/2023,Automotive,True,2063872983125,1751.0,0.0,523529.01,Non-important,pranjal
187,188,08/01/2023,Garden,False,2311037909599,0.0,2586.66,526115.67,Important,pranjal
188,189,08/01/2023,Electronics,True,2317038816532,2105.52,0.0,524010.15,Essential,pranjal
189,190,08/01/2023,Outdoors,False,2413617989858,0.0,1110.42,525120.57,Essential,pranjal
190,191,08/01/2023,Toys,False,2635952652247,0.0,1951.19,527071.76,Non-Essential,pranjal
191,192,08/01/2023,Garden,True,2642360856793,917.41,0.0,526154.35,Non-Essential,pranjal
192,193,09/01/2023,Computers,True,2906220816633,467.07,0.0,525687.28,Essential,pranjal
193,194,09/01/2023,Computers,True,2090245866543,185.3,0.0,525501.98,Important,pranjal
194,195,09/01/2023,Home,True,2120478005869,724.04,0.0,524777.94,Important,pranjal
195,196,09/01/2023,Jewelry,True,2180938949754,1932.32,0.0,522845.62,Non-Essential,pranjal
196,197,09/01/2023,Automotive,True,2285149970971,439.41,0.0,522406.21,Non-Essential,pranjal
197,198,09/01/2023,Movies,True,2460648864654,1720.06,0.0,520686.15,Important,pranjal
198,199,09/01/2023,Clothing,True,2788521512923,168.76,0.0,520517.39,Non-important,pranjal
199,200,09/01/2023,Tools,False,2303299122313,0.0,2783.55,523300.94,Important,pranjal
200,201,09/01/2023,Industrial,True,2648519105398,220.56,0.0,523080.38,Important,pranjal
201,202,09/01/2023,Grocery,False,2236700508192,0.0,447.88,523528.26,Essential,pranjal
202,203,09/01/2023,Baby,True,2152143640055,1466.81,0.0,522061.45,Essential,pranjal
203,204,09/01/2023,Automotive,False,2592128535345,0.0,1947.23,524008.68,Non-important,pranjal
204,205,09/01/2023,Outdoors,True,2208824236589,1124.19,0.0,522884.49,Non-important,pranjal
205,206,10/01/2023,Automotive,True,2237404773983,973.08,0.0,521911.41,Essential,pranjal
206,207,10/01/2023,Outdoors,True,2912881672789,932.68,0.0,520978.73,Essential,pranjal
207,208,10/01/2023,Tools,False,2288539709112,0.0,542.07,521520.8,Non-Essential,pranjal
208,209,10/01/2023,Clothing,True,2778829166631,568.63,0.0,520952.17,Non-Essential,pranjal
209,210,10/01/2023,Clothing,False,2109707504797,0.0,1335.19,522287.36,Non-Essential,pranjal
210,211,10/01/2023,Baby,False,2498568041965,0.0,1248.71,523536.07,Non-important,pranjal
211,212,10/01/2023,Kids,False,2340042315673,0.0,2791.76,526327.83,Essential,pranjal
212,213,11/01/2023,Clothing,True,2697295786596,510.34,0.0,525817.49,Essential,pranjal
213,214,11/01/2023,Sports,False,2846428046887,0.0,1343.29,527160.78,Important,pranjal
214,215,11/01/2023,Health,False,2711538924517,0.0,2425.7,529586.48,Non-important,pranjal
215,216,11/01/2023,Tools,False,2806014300809,0.0,2355.45,531941.93,Important,pranjal
216,217,11/01/2023,Health,False,2548126026658,0.0,1081.3,533023.23,Non-important,pranjal
217,218,11/01/2023,Health,False,2765148465854,0.0,1543.7,534566.93,Non-important,pranjal
218,219,11/01/2023,Electronics,True,2488391882091,2950.53,0.0,531616.4,Non-Essential,pranjal
219,220,11/01/2023,Home,True,2756439065657,19.76,0.0,531596.64,Non-Essential,pranjal
220,221,11/01/2023,Grocery,True,2152598114220,2455.22,0.0,529141.42,Non-important,pranjal
221,222,12/01/2023,Shoes,True,2375906037828,421.57,0.0,528719.85,Essential,pranjal
222,223,12/01/2023,Home,True,2829165331614,430.74,0.0,528289.11,Essential,pranjal
223,224,12/01/2023,Electronics,True,2793337475641,2703.18,0.0,525585.93,Important,pranjal
224,225,12/01/2023,Automotive,True,2072144428804,2525.05,0.0,523060.88,Important,pranjal
225,226,12/01/2023,Sports,True,2817017911883,1776.66,0.0,521284.22,Non-Essential,pranjal
226,227,12/01/2023,Computers,True,2928964906036,2704.41,0.0,518579.81,Important,pranjal
227,228,12/01/2023,Games,False,2010068428573,0.0,665.49,519245.3,Important,pranjal
228,229,12/01/2023,Music,False,2520761623362,0.0,2394.08,521639.38,Essential,pranjal
229,230,12/01/2023,Garden,False,2995929609237,0.0,1590.05,523229.43,Important,pranjal
230,231,12/01/2023,Sports,False,2219654222753,0.0,2636.2,525865.63,Essential,pranjal
231,232,13/01/2023,Kids,True,2396435418457,1030.09,0.0,524835.54,Non-important,pranjal
232,233,13/01/2023,Health,True,2140829463055,2263.76,0.0,522571.78,Non-important,pranjal
233,234,13/01/2023,Electronics,False,2918456631132,0.0,2016.29,524588.07,Important,pranjal
234,235,13/01/2023,Outdoors,True,2085495605281,1007.44,0.0,523580.63,Important,pranjal
235,236,13/01/2023,Movies,False,2384505660306,0.0,59.95,523640.58,Non-important,pranjal
236,237,13/01/2023,Beauty,True,2757306147372,635.28,0.0,523005.3,Important,pranjal
237,238,13/01/2023,Movies,False,2763512954727,0.0,2714.61,525719.91,Non-important,pranjal
238,239,13/01/2023,Toys,False,2499560469657,0.0,1803.92,527523.83,Important,pranjal
239,240,13/01/2023,Jewelry,False,2592639342889,0.0,2704.97,530228.8,Non-Essential,pranjal
240,241,13/01/2023,Health,False,2781112802063,0.0,2039.54,532268.34,Important,pranjal
241,242,14/01/2023,Games,False,2112661404992,0.0,1642.13,533910.47,Non-Essential,pranjal
242,243,14/01/2023,Shoes,True,2617246569747,549.57,0.0,533360.9,Important,pranjal
243,244,14/01/2023,Movies,False,2600035840520,0.0,1658.86,535019.76,Essential,pranjal
244,245,14/01/2023,Outdoors,False,2766509497782,0.0,1412.96,536432.72,Important,pranjal
245,246,14/01/2023,Tools,False,2444953683316,0.0,333.36,536766.08,Non-important,pranjal
246,247,14/01/2023,Automotive,False,2352619787355,0.0,1959.29,538725.37,Important,pranjal
247,248,15/01/2023,Grocery,True,2393099839644,1740.73,0.0,536984.64,Non-Essential,pranjal
248,249,15/01/2023,Clothing,True,2840777407041,2603.59,0.0,534381.05,Non-Essential,pranjal
249,250,15/01/2023,Electronics,False,2870415024307,0.0,2216.64,536597.69,Important,pranjal
250,251,15/01/2023,Jewelry,False,2371389271669,0.0,727.98,537325.67,Essential,pranjal
251,252,15/01/2023,Movies,True,2533066495853,2574.14,0.0,534751.53,Essential,pranjal
252,253,15/01/2023,Electronics,True,2722479831543,1425.11,0.0,533326.42,Non-important,pranjal
253,254,15/01/2023,Toys,False,2627037854045,0.0,2147.36,535473.78,Non-Essential,pranjal
254,255,15/01/2023,Jewelry,True,2284215437529,872.78,0.0,534601.0,Non-Essential,pranjal
255,256,15/01/2023,Games,False,2516319570761,0.0,2000.63,536601.63,Important,pranjal
256,257,15/01/2023,Toys,False,2877826483561,0.0,2588.25,539189.88,Non-Essential,pranjal
257,258,15/01/2023,Home,True,2280610400547,1028.98,0.0,538160.9,Important,pranjal
258,259,16/01/2023,Books,False,2642558762172,0.0,2346.08,540506.98,Non-important,pranjal
259,260,16/01/2023,Home,True,2201468117806,1634.74,0.0,538872.24,Non-important,pranjal
260,261,16/01/2023,Jewelry,True,2357849862420,2388.96,0.0,536483.28,Essential,pranjal
261,262,16/01/2023,Beauty,True,2229665950981,2905.93,0.0,533577.35,Non-Essential,pranjal
262,263,16/01/2023,Home,True,2640460966875,1408.37,0.0,532168.98,Essential,pranjal
263,264,16/01/2023,Baby,True,2794123739795,2437.06,0.0,529731.92,Non-important,pranjal
264,265,16/01/2023,Jewelry,True,2313880561672,568.16,0.0,529163.76,Non-Essential,pranjal
265,266,16/01/2023,Garden,False,2542076690875,0.0,2214.91,531378.67,Important,pranjal
266,267,16/01/2023,Sports,True,2442052566761,2277.96,0.0,529100.71,Non-Essential,pranjal
267,268,16/01/2023,Kids,False,2865296195175,0.0,1898.67,530999.38,Important,pranjal
268,269,16/01/2023,Games,False,2020418006406,0.0,2868.18,533867.56,Non-important,pranjal
269,270,16/01/2023,Jewelry,True,2563152584915,1650.12,0.0,532217.44,Non-important,pranjal
270,271,16/01/2023,Kids,False,2910932519744,0.0,2652.82,534870.26,Essential,pranjal
271,272,17/01/2023,Health,True,2104121424241,1335.28,0.0,533534.98,Important,pranjal
272,273,17/01/2023,Computers,True,2567488632987,705.14,0.0,532829.84,Non-important,pranjal
273,274,17/01/2023,Sports,False,2435545723023,0.0,54.78,532884.62,Non-Essential,pranjal
274,275,17/01/2023,Electronics,True,2351947349656,2839.94,0.0,530044.68,Essential,pranjal
275,276,17/01/2023,Music,True,2774513516607,2095.4,0.0,527949.28,Important,pranjal
276,277,17/01/2023,Baby,False,2912647479832,0.0,104.4,528053.68,Essential,pranjal
277,278,17/01/2023,Computers,True,2690692442569,1560.11,0.0,526493.57,Essential,pranjal
278,279,17/01/2023,Shoes,True,2608319957300,1138.3,0.0,525355.27,Non-important,pranjal
279,280,17/01/2023,Music,False,2623087121539,0.0,726.67,526081.94,Non-important,pranjal
280,281,18/01/2023,Shoes,False,2700501339518,0.0,966.81,527048.75,Non-Essential,pranjal
281,282,18/01/2023,Automotive,True,2534529621114,1384.2,0.0,525664.55,Important,pranjal
282,283,18/01/2023,Jewelry,False,2560955350204,0.0,1294.35,526958.9,Important,pranjal
283,284,18/01/2023,Sports,True,2649469873377,1880.48,0.0,525078.42,Non-important,pranjal
284,285,18/01/2023,Games,False,2207809659025,0.0,1384.85,526463.27,Essential,pranjal
285,286,18/01/2023,Grocery,False,2157443602998,0.0,1528.5,527991.77,Important,pranjal
286,287,18/01/2023,Tools,True,2709696098316,2443.16,0.0,525548.61,Non-Essential,pranjal
287,288,18/01/2023,Jewelry,True,2524148977578,735.42,0.0,524813.19,Non-Essential,pranjal
288,289,18/01/2023,Sports,True,2949867149918,1861.78,0.0,522951.41,Important,pranjal
289,290,19/01/2023,Automotive,True,2444958084265,65.02,0.0,522886.39,Important,pranjal
290,291,19/01/2023,Electronics,False,2127919481632,0.0,2169.35,525055.74,Important,pranjal
291,292,19/01/2023,Beauty,True,2860847001904,2737.44,0.0,522318.3,Essential,pranjal
292,293,19/01/2023,Garden,False,2682138905128,0.0,1989.52,524307.82,Important,pranjal
293,294,19/01/2023,Music,True,2599699378512,892.87,0.0,523414.95,Important,pranjal
294,295,19/01/2023,Computers,False,2867277136988,0.0,618.23,524033.18,Essential,pranjal
295,296,19/01/2023,Kids,False,2097747169798,0.0,628.93,524662.11,Important,pranjal
296,297,19/01/2023,Tools,True,2578397899068,913.95,0.0,523748.16,Non-important,pranjal
297,298,19/01/2023,Clothing,True,2119776309954,737.23,0.0,523010.93,Important,pranjal
298,299,19/01/2023,Grocery,True,2192034104312,1961.2,0.0,521049.73,Non-Essential,pranjal
299,300,19/01/2023,Electronics,True,2162286387881,2080.96,0.0,518968.77,Non-Essential,pranjal
300,301,19/01/2023,Books,True,2302057460979,1349.49,0.0,517619.28,Important,pranjal
301,302,20/01/2023,Computers,True,2848918535218,2981.94,0.0,514637.34,Non-important,pranjal
302,303,20/01/2023,Baby,True,2999993196732,865.31,0.0,513772.03,Essential,pranjal
303,304,20/01/2023,Baby,True,2745036853567,1182.51,0.0,512589.52,Non-Essential,pranjal
304,305,20/01/2023,Outdoors,True,2837031311766,1971.03,0.0,510618.49,Non-Essential,pranjal
305,306,20/01/2023,Outdoors,False,2818512155463,0.0,788.12,511406.61,Non-Essential,pranjal
306,307,20/01/2023,Industrial,False,2014244166226,0.0,2136.89,513543.5,Important,pranjal
307,308,20/01/2023,Shoes,True,2674658127202,2103.07,0.0,511440.43,Non-Essential,pranjal
308,309,20/01/2023,Books,False,2826799141996,0.0,1916.53,513356.96,Non-important,pranjal
309,310,20/01/2023,Health,True,2004841752898,2428.27,0.0,510928.69,Non-Essential,pranjal
310,311,20/01/2023,Baby,True,2236760677160,439.98,0.0,510488.71,Non-Essential,pranjal
311,312,21/01/2023,Music,True,2615732589751,522.58,0.0,509966.13,Non-Essential,pranjal
312,313,21/01/2023,Industrial,False,2006393143692,0.0,1841.74,511807.87,Non-important,pranjal
313,314,21/01/2023,Kids,False,2745845603403,0.0,1396.92,513204.79,Non-Essential,pranjal
314,315,21/01/2023,Movies,False,2614601816552,0.0,2622.42,515827.21,Essential,pranjal
315,316,21/01/2023,Tools,False,2714851550409,0.0,817.51,516644.72,Important,pranjal
316,317,21/01/2023,Kids,True,2792672631733,795.45,0.0,515849.27,Non-Essential,pranjal
317,318,22/01/2023,Movies,True,2211480188284,785.34,0.0,515063.93,Essential,pranjal
318,319,22/01/2023,Tools,True,2103846974319,246.46,0.0,514817.47,Non-important,pranjal
319,320,22/01/2023,Outdoors,True,2733672634541,749.31,0.0,514068.16,Important,pranjal
320,321,22/01/2023,Garden,True,2641142789285,663.95,0.0,513404.21,Essential,pranjal
321,322,22/01/2023,Home,False,2073707173277,0.0,2405.58,515809.79,Non-important,pranjal
322,323,22/01/2023,Books,False,2413700918492,0.0,1933.51,517743.3,Important,pranjal
323,324,22/01/2023,Industrial,True,2300139479478,2246.14,0.0,515497.16,Non-Essential,pranjal
324,325,22/01/2023,Baby,True,2233213040139,2413.79,0.0,513083.37,Important,pranjal
325,326,22/01/2023,Books,False,2238564392039,0.0,277.65,513361.02,Important,pranjal
326,327,22/01/2023,Garden,False,2269837084597,0.0,212.3,513573.32,Important,pranjal
327,328,22/01/2023,Games,True,2970932150901,2554.16,0.0,511019.16,Important,pranjal
328,329,22/01/2023,Toys,True,2475993638281,2148.68,0.0,508870.48,Important,pranjal
329,330,22/01/2023,Sports,False,2258820572747,0.0,1164.87,510035.35,Essential,pranjal
330,331,22/01/2023,Sports,False,2022212078552,0.0,2441.43,512476.78,Essential,pranjal
331,332,22/01/2023,Games,False,2090049147343,0.0,1108.33,513585.11,Important,pranjal
332,333,22/01/2023,Automotive,True,2829729652266,2283.58,0.0,511301.53,Non-Essential,pranjal
333,334,23/01/2023,Garden,False,2275073620069,0.0,1346.71,512648.24,Non-important,pranjal
334,335,23/01/2023,Garden,True,2733349715024,2318.88,0.0,510329.36,Non-Essential,pranjal
335,336,23/01/2023,Grocery,False,2605294346818,0.0,2416.2,512745.56,Non-Essential,pranjal
336,337,23/01/2023,Toys,True,2276068812750,1030.2,0.0,511715.36,Non-important,pranjal
337,338,23/01/2023,Games,False,2321342739152,0.0,1458.69,513174.05,Essential,pranjal
338,339,23/01/2023,Sports,False,2573001972152,0.0,204.67,513378.72,Non-important,pranjal
339,340,23/01/2023,Kids,False,2731388491325,0.0,1330.6,514709.32,Important,pranjal
340,341,23/01/2023,Beauty,True,2883098763897,1860.96,0.0,512848.36,Non-Essential,pranjal
341,342,23/01/2023,Grocery,False,2401997606506,0.0,945.19,513793.55,Non-important,pranjal
342,343,23/01/2023,Industrial,True,2007743061828,233.91,0.0,513559.64,Non-Essential,pranjal
343,344,23/01/2023,Computers,True,2451131240225,2362.52,0.0,511197.12,Non-important,pranjal
344,345,23/01/2023,Kids,False,2682677036288,0.0,1760.39,512957.51,Non-Essential,pranjal
345,346,23/01/2023,Kids,True,2943597713161,9.81,0.0,512947.7,Important,pranjal
346,347,23/01/2023,Shoes,False,2509067628587,0.0,981.9,513929.6,Important,pranjal
347,348,24/01/2023,Industrial,True,2298411538974,2454.83,0.0,511474.77,Non-Essential,pranjal
348,349,24/01/2023,Beauty,False,2994853772518,0.0,334.97,511809.74,Essential,pranjal
349,350,24/01/2023,Health,False,2292331830081,0.0,1601.31,513411.05,Essential,pranjal
350,351,24/01/2023,Electronics,True,2193060833194,1559.92,0.0,511851.13,Non-Essential,pranjal
351,352,24/01/2023,Outdoors,False,2787474586829,0.0,2000.94,513852.07,Non-Essential,pranjal
352,353,24/01/2023,Baby,True,2781355656509,2389.65,0.0,511462.42,Non-Essential,pranjal
353,354,24/01/2023,Books,False,2939721468069,0.0,886.1,512348.52,Non-important,pranjal
354,355,24/01/2023,Grocery,True,2520407806484,1096.3,0.0,511252.22,Important,pranjal
355,356,24/01/2023,Grocery,True,2957521264851,2782.07,0.0,508470.15,Non-important,pranjal
356,357,25/01/2023,Beauty,False,2234598094033,0.0,2485.66,510955.81,Important,pranjal
357,358,25/01/2023,Health,False,2547199207179,0.0,1762.92,512718.73,Essential,pranjal
358,359,25/01/2023,Movies,True,2689492049515,48.26,0.0,512670.47,Non-important,pranjal
359,360,25/01/2023,Automotive,True,2177339818589,2502.65,0.0,510167.82,Non-important,pranjal
360,361,25/01/2023,Industrial,True,2984467395588,953.21,0.0,509214.61,Non-Essential,pranjal
361,362,25/01/2023,Kids,True,2468301537998,2250.58,0.0,506964.03,Non-important,pranjal
362,363,25/01/2023,Health,True,2378913483005,621.56,0.0,506342.47,Important,pranjal
363,364,25/01/2023,Clothing,False,2782734593082,0.0,903.68,507246.15,Important,pranjal
364,365,25/01/2023,Jewelry,False,2236387704478,0.0,1018.79,508264.94,Non-Essential,pranjal
365,366,25/01/2023,Electronics,True,2328663925937,446.78,0.0,507818.16,Essential,pranjal
366,367,25/01/2023,Beauty,True,2437315636836,77.28,0.0,507740.88,Essential,pranjal
367,368,26/01/2023,Kids,True,2582921773831,747.6,0.0,506993.28,Important,pranjal
368,369,26/01/2023,Tools,False,2522710072521,0.0,1385.12,508378.4,Important,pranjal
369,370,26/01/2023,Shoes,True,2333637644168,115.69,0.0,508262.71,Non-important,pranjal
370,371,26/01/2023,Sports,True,2673437933039,1063.42,0.0,507199.29,Essential,pranjal
371,372,26/01/2023,Kids,True,2142659541748,1022.46,0.0,506176.83,Non-important,pranjal
372,373,26/01/2023,Home,False,2468816592812,0.0,1076.6,507253.43,Non-Essential,pranjal
373,374,27/01/2023,Tools,True,2022785734744,561.5,0.0,506691.93,Essential,pranjal
374,375,27/01/2023,Automotive,True,2837880907792,2035.89,0.0,504656.04,Non-important,pranjal
375,376,27/01/2023,Books,True,2305184746957,202.56,0.0,504453.48,Non-Essential,pranjal
376,377,27/01/2023,Kids,False,2745731844580,0.0,1093.93,505547.41,Non-important,pranjal
377,378,27/01/2023,Grocery,False,2808604701033,0.0,1602.72,507150.13,Non-Essential,pranjal
378,379,27/01/2023,Electronics,True,2570710721816,401.11,0.0,506749.02,Essential,pranjal
379,380,27/01/2023,Grocery,False,2768616787533,0.0,1564.01,508313.03,Non-important,pranjal
380,381,27/01/2023,Movies,True,2356697611898,1189.77,0.0,507123.26,Essential,pranjal
381,382,27/01/2023,Home,True,2288688471385,1669.19,0.0,505454.07,Non-Essential,pranjal
382,383,27/01/2023,Health,False,2522487843183,0.0,1193.7,506647.77,Essential,pranjal
383,384,27/01/2023,Clothing,True,2696923222508,1503.72,0.0,505144.05,Essential,pranjal
384,385,27/01/2023,Games,False,2585253830600,0.0,1501.55,506645.6,Non-important,pranjal
385,386,27/01/2023,Grocery,False,2762478519487,0.0,608.53,507254.13,Non-important,pranjal
386,387,28/01/2023,Kids,True,2228715543874,2681.17,0.0,504572.96,Essential,pranjal
387,388,28/01/2023,Beauty,True,2037584189292,9.45,0.0,504563.51,Non-important,pranjal
388,389,28/01/2023,Home,True,2807638347452,160.82,0.0,504402.69,Non-important,pranjal
389,390,28/01/2023,Garden,False,2384472239984,0.0,1308.56,505711.25,Non-important,pranjal
390,391,28/01/2023,Automotive,False,2395650023316,0.0,1880.01,507591.26,Important,pranjal
391,392,28/01/2023,Clothing,True,2354061606259,1380.3,0.0,506210.96,Essential,pranjal
392,393,28/01/2023,Games,True,2786483948543,736.96,0.0,505474.0,Non-Essential,pranjal
393,394,28/01/2023,Home,False,2532537084062,0.0,707.79,506181.79,Non-Essential,pranjal
394,395,28/01/2023,Books,False,2072640571106,0.0,475.14,506656.93,Essential,pranjal
395,396,28/01/2023,Games,False,2794583265677,0.0,2953.28,509610.21,Important,pranjal
396,397,28/01/2023,Automotive,True,2981758125664,1650.79,0.0,507959.42,Non-important,pranjal
397,398,29/01/2023,Toys,False,2986008545019,0.0,2045.96,510005.38,Important,pranjal
398,399,29/01/2023,Automotive,False,2497495605275,0.0,1635.01,511640.39,Non-important,pranjal
399,400,29/01/2023,Baby,True,2588670804952,863.72,0.0,510776.67,Important,pranjal
400,401,29/01/2023,Music,False,2087996245924,0.0,921.27,511697.94,Non-important,pranjal
401,402,29/01/2023,Industrial,True,2036658914385,421.08,0.0,511276.86,Non-important,pranjal
402,403,29/01/2023,Industrial,True,2027408382074,1949.7,0.0,509327.16,Essential,pranjal
403,404,29/01/2023,Movies,False,2552271053569,0.0,447.76,509774.92,Non-Essential,pranjal
404,405,29/01/2023,Shoes,True,2669349459559,142.95,0.0,509631.97,Non-Essential,pranjal
405,406,29/01/2023,Sports,False,2951329892439,0.0,1071.41,510703.38,Non-important,pranjal
406,407,29/01/2023,Kids,True,2963858331561,471.7,0.0,510231.68,Essential,pranjal
407,408,29/01/2023,Beauty,False,2829307286371,0.0,2572.93,512804.61,Important,pranjal
408,409,30/01/2023,Health,False,2911645299090,0.0,2868.73,515673.34,Important,pranjal
409,410,30/01/2023,Movies,True,2126907643258,1839.49,0.0,513833.85,Essential,pranjal
410,411,30/01/2023,Sports,True,2128389922439,1187.37,0.0,512646.48,Non-Essential,pranjal
411,412,30/01/2023,Kids,True,2975105600497,1420.14,0.0,511226.34,Essential,pranjal
412,413,30/01/2023,Music,True,2563161389593,780.64,0.0,510445.7,Essential,pranjal
413,414,30/01/2023,Beauty,True,2775601163769,317.24,0.0,510128.46,Non-Essential,pranjal
414,415,30/01/2023,Kids,True,2846375807375,1961.72,0.0,508166.74,Non-important,pranjal
415,416,30/01/2023,Health,False,2250756987963,0.0,2154.34,510321.08,Essential,pranjal
416,417,31/01/2023,Books,False,2087074512865,0.0,1038.6,511359.68,Important,pranjal
417,418,31/01/2023,Sports,False,2752352791076,0.0,1101.97,512461.65,Essential,pranjal
418,419,31/01/2023,Garden,False,2118389842259,0.0,1331.22,513792.87,Non-Essential,pranjal
419,420,31/01/2023,Computers,True,2783832170571,1145.4,0.0,512647.47,Non-Essential,pranjal
420,421,31/01/2023,Grocery,False,2889705940603,0.0,2411.45,515058.92,Essential,pranjal
421,422,31/01/2023,Home,False,2579475234901,0.0,1969.1,517028.02,Essential,pranjal
422,423,31/01/2023,Garden,False,2548968578273,0.0,157.74,517185.76,Important,pranjal
423,424,31/01/2023,Toys,True,2047429360801,199.43,0.0,516986.33,Important,pranjal
424,425,31/01/2023,Home,False,2115297891793,0.0,465.89,517452.22,Essential,pranjal
425,426,31/01/2023,Tools,True,2622980550773,166.89,0.0,517285.33,Non-important,pranjal
426,427,01/02/2023,Electronics,True,2289432106857,493.19,0.0,516792.14,Non-important,pranjal
427,428,01/02/2023,Health,False,2081465538338,0.0,2299.12,519091.26,Essential,pranjal
428,429,01/02/2023,Computers,True,2610266018961,741.52,0.0,518349.74,Non-Essential,pranjal
429,430,01/02/2023,Games,True,2114471951369,1835.06,0.0,516514.68,Non-important,pranjal
430,431,01/02/2023,Kids,False,2946646495606,0.0,922.85,517437.53,Essential,pranjal
431,432,01/02/2023,Clothing,True,2505353895852,2709.05,0.0,514728.48,Important,pranjal
432,433,01/02/2023,Garden,True,2269580269496,1425.16,0.0,513303.32,Non-important,pranjal
433,434,01/02/2023,Health,True,2241627741719,852.6,0.0,512450.72,Non-important,pranjal
434,435,01/02/2023,Garden,False,2965638143504,0.0,1094.06,513544.78,Non-important,pranjal
435,436,01/02/2023,Beauty,True,2003444057002,936.71,0.0,512608.07,Non-important,pranjal
436,437,01/02/2023,Grocery,False,2877607506753,0.0,2199.63,514807.7,Non-important,pranjal
437,438,01/02/2023,Sports,True,2066342945633,850.71,0.0,513956.99,Non-Essential,pranjal
438,439,01/02/2023,Music,False,2476548494333,0.0,2656.69,516613.68,Essential,pranjal
439,440,01/02/2023,Automotive,False,2831657504055,0.0,2636.09,519249.77,Important,pranjal
440,441,01/02/2023,Music,True,2970392522430,2434.73,0.0,516815.04,Essential,pranjal
441,442,02/02/2023,Music,False,2186478884956,0.0,1504.07,518319.11,Essential,pranjal
442,443,02/02/2023,Garden,False,2354720480252,0.0,2667.66,520986.77,Non-important,pranjal
443,444,02/02/2023,Beauty,True,2154411487795,866.08,0.0,520120.69,Non-important,pranjal
444,445,02/02/2023,Grocery,True,2113549945475,1481.82,0.0,518638.87,Non-important,pranjal
445,446,02/02/2023,Toys,False,2243037306499,0.0,614.12,519252.99,Non-Essential,pranjal
446,447,02/02/2023,Outdoors,True,2866686511840,531.66,0.0,518721.33,Essential,pranjal
447,448,02/02/2023,Toys,True,2880924794895,1624.86,0.0,517096.47,Important,pranjal
448,449,02/02/2023,Games,False,2654511305207,0.0,1158.94,518255.41,Essential,pranjal
449,450,02/02/2023,Computers,False,2137746032842,0.0,1993.68,520249.09,Essential,pranjal
450,451,02/02/2023,Computers,True,2914093366926,2004.83,0.0,518244.26,Non-important,pranjal
451,452,02/02/2023,Garden,True,2454721599209,1748.62,0.0,516495.64,Important,pranjal
452,453,03/02/2023,Games,True,2370116528072,2296.38,0.0,514199.26,Non-important,pranjal
453,454,03/02/2023,Clothing,False,2398340531147,0.0,675.98,514875.24,Important,pranjal
454,455,03/02/2023,Kids,False,2410089339355,0.0,1931.76,516807.0,Important,pranjal
455,456,03/02/2023,Electronics,False,2539855203403,0.0,5.38,516812.38,Non-Essential,pranjal
456,457,03/02/2023,Shoes,True,2513016284005,320.7,0.0,516491.68,Essential,pranjal
457,458,03/02/2023,Industrial,True,2310676911659,2050.79,0.0,514440.89,Important,pranjal
458,459,03/02/2023,Jewelry,False,2027184401760,0.0,277.12,514718.01,Essential,pranjal
459,460,03/02/2023,Tools,False,2952667735924,0.0,1757.7,516475.71,Non-Essential,pranjal
460,461,03/02/2023,Beauty,False,2993337301624,0.0,1007.89,517483.6,Essential,pranjal
461,462,03/02/2023,Automotive,False,2936942498578,0.0,2652.09,520135.69,Essential,pranjal
462,463,03/02/2023,Grocery,True,2100122913029,892.82,0.0,519242.87,Non-Essential,pranjal
463,464,03/02/2023,Shoes,True,2654564032539,1224.78,0.0,518018.09,Important,pranjal
464,465,03/02/2023,Clothing,True,2925382868064,473.55,0.0,517544.54,Non-important,pranjal
465,466,03/02/2023,Health,True,2848741408041,1562.93,0.0,515981.61,Essential,pranjal
466,467,03/02/2023,Music,True,2950704231649,1716.45,0.0,514265.16,Non-Essential,pranjal
467,468,03/02/2023,Computers,True,2154908448193,1110.11,0.0,513155.05,Essential,pranjal
468,469,03/02/2023,Industrial,True,2098547394495,1848.23,0.0,511306.82,Non-important,pranjal
469,470,03/02/2023,Outdoors,True,2274467279624,1284.11,0.0,510022.71,Essential,pranjal
470,471,03/02/2023,Home,True,2051246414476,388.2,0.0,509634.51,Essential,pranjal
471,472,04/02/2023,Music,True,2517400602324,2207.2,0.0,507427.31,Non-Essential,pranjal
472,473,04/02/2023,Computers,True,2194911366985,79.68,0.0,507347.63,Essential,pranjal
473,474,04/02/2023,Jewelry,True,2501057677847,1399.04,0.0,505948.59,Non-Essential,pranjal
474,475,04/02/2023,Industrial,False,2414546199464,0.0,1124.43,507073.02,Non-important,pranjal
475,476,04/02/2023,Jewelry,True,2877153943503,1545.61,0.0,505527.41,Essential,pranjal
476,477,04/02/2023,Tools,True,2952446881777,1056.14,0.0,504471.27,Non-Essential,pranjal
477,478,04/02/2023,Shoes,False,2198609155050,0.0,1726.4,506197.67,Non-important,pranjal
478,479,04/02/2023,Music,False,2054339060361,0.0,184.97,506382.64,Non-important,pranjal
479,480,04/02/2023,Baby,False,2847409690088,0.0,1625.99,508008.63,Essential,pranjal
480,481,04/02/2023,Toys,False,2550177181785,0.0,64.72,508073.35,Important,pranjal
481,482,04/02/2023,Jewelry,False,2950988103117,0.0,260.32,508333.67,Essential,pranjal
482,483,05/02/2023,Movies,True,2567301366199,438.34,0.0,507895.33,Non-important,pranjal
483,484,05/02/2023,Garden,False,2755314131567,0.0,20.32,507915.65,Important,pranjal
484,485,05/02/2023,Baby,True,2740419370013,698.15,0.0,507217.5,Non-Essential,pranjal
485,486,05/02/2023,Automotive,False,2275460069371,0.0,1962.5,509180.0,Important,pranjal
486,487,05/02/2023,Jewelry,False,2938814015208,0.0,391.39,509571.39,Essential,pranjal
487,488,05/02/2023,Clothing,True,2802252488276,955.73,0.0,508615.66,Important,pranjal
488,489,05/02/2023,Health,True,2865544680379,778.62,0.0,507837.04,Non-important,pranjal
489,490,05/02/2023,Toys,False,2551658542459,0.0,1077.93,508914.97,Essential,pranjal
490,491,05/02/2023,Grocery,False,2881847053884,0.0,1490.91,510405.88,Important,pranjal
491,492,05/02/2023,Automotive,True,2926181536803,1985.81,0.0,508420.07,Important,pranjal
492,493,06/02/2023,Automotive,False,2586620021772,0.0,2622.87,511042.94,Important,pranjal
493,494,06/02/2023,Automotive,False,2388238204331,0.0,365.78,511408.72,Non-important,pranjal
494,495,06/02/2023,Electronics,False,2624940577309,0.0,1459.32,512868.04,Non-Essential,pranjal
495,496,06/02/2023,Home,False,2155946484334,0.0,194.11,513062.15,Essential,pranjal
496,497,06/02/2023,Garden,True,2608503714720,1980.21,0.0,511081.94,Important,pranjal
497,498,06/02/2023,Jewelry,True,2707526700533,609.84,0.0,510472.1,Non-Essential,pranjal
498,499,06/02/2023,Games,True,2006758253044,693.7,0.0,509778.4,Non-Essential,pranjal
499,500,06/02/2023,Home,True,2656252163255,827.75,0.0,508950.65,Important,pranjal
500,501,06/02/2023,Books,True,2313834412915,1988.59,0.0,506962.06,Important,pranjal
501,502,06/02/2023,Health,False,2058535605152,0.0,2311.73,509273.79,Non-important,pranjal
502,503,06/02/2023,Movies,False,2985799430682,0.0,2033.76,511307.55,Essential,pranjal
503,504,06/02/2023,Games,False,2673542072782,0.0,1850.2,513157.75,Non-important,pranjal
504,505,07/02/2023,Health,True,2688169651251,832.66,0.0,512325.09,Important,pranjal
505,506,07/02/2023,Tools,False,2882969558460,0.0,1093.85,513418.94,Important,pranjal
506,507,07/02/2023,Computers,True,2028928840118,2226.79,0.0,511192.15,Non-Essential,pranjal
507,508,07/02/2023,Music,False,2336982830611,0.0,910.86,512103.01,Essential,pranjal
508,509,07/02/2023,Music,True,2095136415468,973.04,0.0,511129.97,Non-important,pranjal
509,510,07/02/2023,Clothing,False,2623170159681,0.0,796.23,511926.2,Non-important,pranjal
510,511,07/02/2023,Beauty,False,2699125596797,0.0,1038.07,512964.27,Non-important,pranjal
511,512,07/02/2023,Movies,True,2858292359125,2270.85,0.0,510693.42,Non-important,pranjal
512,513,07/02/2023,Music,True,2919761861003,2032.96,0.0,508660.46,Essential,pranjal
513,514,07/02/2023,Industrial,True,2050173676474,2215.12,0.0,506445.34,Non-important,pranjal
514,515,07/02/2023,Books,True,2252126045025,1479.85,0.0,504965.49,Non-Essential,pranjal
515,516,07/02/2023,Computers,False,2978542781890,0.0,2341.58,507307.07,Non-important,pranjal
516,517,07/02/2023,Movies,False,2612383619648,0.0,439.43,507746.5,Non-important,pranjal
517,518,07/02/2023,Kids,False,2630183732639,0.0,2252.81,509999.31,Important,pranjal
518,519,07/02/2023,Clothing,False,2639751617793,0.0,2580.28,512579.59,Non-Essential,pranjal
519,520,07/02/2023,Movies,True,2165949283618,943.91,0.0,511635.68,Important,pranjal
520,521,07/02/2023,Music,False,2973350957371,0.0,285.51,511921.19,Important,pranjal
521,522,08/02/2023,Electronics,True,2396584938425,2319.98,0.0,509601.21,Non-important,pranjal
522,523,08/02/2023,Outdoors,False,2746348884130,0.0,202.4,509803.61,Important,pranjal
523,524,08/02/2023,Kids,False,2925204012413,0.0,2709.32,512512.93,Non-Essential,pranjal
524,525,08/02/2023,Movies,True,2101435329993,2395.1,0.0,510117.83,Essential,pranjal
525,526,08/02/2023,Beauty,False,2699930007397,0.0,1893.2,512011.03,Important,pranjal
526,527,09/02/2023,Computers,False,2632097722653,0.0,816.03,512827.06,Non-important,pranjal
527,528,09/02/2023,Electronics,True,2945893801266,774.28,0.0,512052.78,Non-Essential,pranjal
528,529,09/02/2023,Games,True,2191320169377,637.62,0.0,511415.16,Important,pranjal
529,530,09/02/2023,Sports,False,2869963697036,0.0,982.37,512397.53,Important,pranjal
530,531,09/02/2023,Music,False,2674291859505,0.0,2496.33,514893.86,Important,pranjal
531,532,09/02/2023,Movies,True,2372024840036,790.56,0.0,514103.3,Non-important,pranjal
532,533,10/02/2023,Books,True,2867918089972,2381.57,0.0,511721.73,Non-Essential,pranjal
533,534,10/02/2023,Garden,True,2704900143643,2076.19,0.0,509645.54,Important,pranjal
534,535,10/02/2023,Home,False,2699310569344,0.0,2156.98,511802.52,Non-important,pranjal
535,536,10/02/2023,Health,False,2754327083838,0.0,2664.89,514467.41,Non-Essential,pranjal
536,537,10/02/2023,Home,True,2143949721600,945.27,0.0,513522.14,Important,pranjal
537,538,10/02/2023,Garden,False,2524543087186,0.0,2078.19,515600.33,Important,pranjal
538,539,10/02/2023,Outdoors,False,2854712733297,0.0,1073.38,516673.71,Important,pranjal
539,540,10/02/2023,Books,False,2937165498127,0.0,338.9,517012.61,Important,pranjal
540,541,11/02/2023,Automotive,True,2768944525042,2361.02,0.0,514651.59,Non-important,pranjal
541,542,11/02/2023,Industrial,False,2817557370311,0.0,594.98,515246.57,Non-Essential,pranjal
542,543,11/02/2023,Automotive,True,2455314687440,395.38,0.0,514851.19,Non-important,pranjal
543,544,11/02/2023,Sports,True,2497195827344,2965.66,0.0,511885.53,Important,pranjal
544,545,11/02/2023,Tools,False,2153475540476,0.0,2151.83,514037.36,Non-important,pranjal
545,546,11/02/2023,Clothing,True,2627698756515,1596.36,0.0,512441.0,Non-important,pranjal
546,547,11/02/2023,Grocery,True,2508552636976,1366.88,0.0,511074.12,Non-important,pranjal
547,548,11/02/2023,Movies,False,2155785846528,0.0,813.67,511887.79,Important,pranjal
548,549,11/02/2023,Computers,False,2959065785659,0.0,2120.57,514008.36,Non-Essential,pranjal
549,550,11/02/2023,Outdoors,False,2564228845369,0.0,2070.76,516079.12,Essential,pranjal
550,551,12/02/2023,Beauty,True,2794796125467,308.38,0.0,515770.74,Non-Essential,pranjal
551,552,12/02/2023,Garden,True,2677997665752,343.17,0.0,515427.57,Important,pranjal
552,553,12/02/2023,Music,True,2501771722677,2753.14,0.0,512674.43,Essential,pranjal
553,554,12/02/2023,Games,True,2494277084003,1508.7,0.0,511165.73,Essential,pranjal
554,555,12/02/2023,Computers,False,2436669649417,0.0,1268.03,512433.76,Non-Essential,pranjal
555,556,12/02/2023,Kids,True,2804918396894,1094.26,0.0,511339.5,Important,pranjal
556,557,12/02/2023,Clothing,False,2689627099941,0.0,2403.18,513742.68,Essential,pranjal
557,558,12/02/2023,Automotive,True,2219898814997,464.97,0.0,513277.71,Non-Essential,pranjal
558,559,12/02/2023,Tools,True,2570042838340,1060.27,0.0,512217.44,Non-Essential,pranjal
559,560,12/02/2023,Baby,False,2756703285547,0.0,194.41,512411.85,Important,pranjal
560,561,12/02/2023,Outdoors,False,2713655484275,0.0,810.69,513222.54,Non-important,pranjal
561,562,12/02/2023,Automotive,True,2674400566325,2873.27,0.0,510349.27,Important,pranjal
562,563,12/02/2023,Industrial,True,2263865467902,2212.4,0.0,508136.87,Non-important,pranjal
563,564,13/02/2023,Outdoors,True,2425205235182,2946.42,0.0,505190.45,Essential,pranjal
564,565,13/02/2023,Beauty,True,2992027122829,616.49,0.0,504573.96,Non-important,pranjal
565,566,13/02/2023,Computers,False,2817974335691,0.0,946.89,505520.85,Important,pranjal
566,567,13/02/2023,Automotive,True,2970868214716,2356.32,0.0,503164.53,Non-important,pranjal
567,568,13/02/2023,Toys,False,2206782865979,0.0,1228.11,504392.64,Non-Essential,pranjal
568,569,13/02/2023,Garden,False,2844287099256,0.0,2152.83,506545.47,Non-Essential,pranjal
569,570,13/02/2023,Shoes,True,2284014265586,712.83,0.0,505832.64,Essential,pranjal
570,571,13/02/2023,Outdoors,False,2513753059765,0.0,132.29,505964.93,Essential,pranjal
571,572,13/02/2023,Computers,True,2419357063778,2395.5,0.0,503569.43,Non-important,pranjal
572,573,13/02/2023,Beauty,False,2008903374530,0.0,998.7,504568.13,Non-important,pranjal
573,574,13/02/2023,Beauty,False,2040330589064,0.0,1799.75,506367.88,Non-important,pranjal
574,575,14/02/2023,Baby,False,2804360218092,0.0,306.38,506674.26,Non-Essential,pranjal
575,576,14/02/2023,Home,False,2810078134396,0.0,138.03,506812.29,Important,pranjal
576,577,14/02/2023,Movies,True,2561477765277,558.31,0.0,506253.98,Non-Essential,pranjal
577,578,14/02/2023,Games,False,2582121472960,0.0,33.51,506287.49,Non-important,pranjal
578,579,14/02/2023,Music,True,2643137322006,1300.35,0.0,504987.14,Non-Essential,pranjal
579,580,14/02/2023,Tools,False,2006441339716,0.0,74.39,505061.53,Essential,pranjal
580,581,15/02/2023,Music,False,2510280890723,0.0,530.06,505591.59,Non-important,pranjal
581,582,15/02/2023,Toys,False,2319193295792,0.0,877.02,506468.61,Essential,pranjal
582,583,15/02/2023,Computers,False,2255898293209,0.0,508.43,506977.04,Important,pranjal
583,584,15/02/2023,Automotive,False,2099599892816,0.0,161.81,507138.85,Important,pranjal
584,585,15/02/2023,Electronics,False,2431397358431,0.0,1091.52,508230.37,Non-important,pranjal
585,586,15/02/2023,Tools,False,2102463903535,0.0,1339.87,509570.24,Non-important,pranjal
586,587,15/02/2023,Beauty,False,2105733199958,0.0,762.33,510332.57,Essential,pranjal
587,588,15/02/2023,Tools,False,2378294503035,0.0,1500.37,511832.94,Essential,pranjal
588,589,15/02/2023,Clothing,True,2455520327880,599.21,0.0,511233.73,Non-Essential,pranjal
589,590,15/02/2023,Industrial,True,2877882811424,1984.25,0.0,509249.48,Important,pranjal
590,591,15/02/2023,Books,False,2533272528808,0.0,756.57,510006.05,Non-important,pranjal
591,592,15/02/2023,Beauty,True,2817754161632,1439.76,0.0,508566.29,Non-Essential,pranjal
592,593,15/02/2023,Home,False,2364646968636,0.0,183.53,508749.82,Non-important,pranjal
593,594,15/02/2023,Jewelry,True,2615786275144,342.6,0.0,508407.22,Non-Essential,pranjal
594,595,15/02/2023,Computers,True,2361680436394,2217.02,0.0,506190.2,Non-important,pranjal
595,596,16/02/2023,Sports,True,2068800935290,1612.82,0.0,504577.38,Essential,pranjal
596,597,16/02/2023,Automotive,False,2986343411660,0.0,1706.81,506284.19,Non-important,pranjal
597,598,16/02/2023,Beauty,False,2120006626275,0.0,488.16,506772.35,Important,pranjal
598,599,16/02/2023,Music,True,2864731057906,1145.42,0.0,505626.93,Non-Essential,pranjal
599,600,16/02/2023,Grocery,True,2613243767744,14.35,0.0,505612.58,Essential,pranjal
600,601,16/02/2023,Toys,False,2857318268951,0.0,545.04,506157.62,Essential,pranjal
601,602,16/02/2023,Automotive,True,2416793163559,2805.41,0.0,503352.21,Non-Essential,pranjal
602,603,16/02/2023,Home,True,2577180276510,2055.18,0.0,501297.03,Non-important,pranjal
603,604,16/02/2023,Sports,False,2384667237124,0.0,2122.38,503419.41,Non-Essential,pranjal
604,605,16/02/2023,Electronics,True,2733541700763,2276.62,0.0,501142.79,Important,pranjal
605,606,16/02/2023,Toys,True,2238537881038,59.64,0.0,501083.15,Non-Essential,pranjal
606,607,16/02/2023,Kids,False,2292995993581,0.0,2371.69,503454.84,Non-important,pranjal
607,608,17/02/2023,Home,False,2422827924317,0.0,2387.14,505841.98,Important,pranjal
608,609,17/02/2023,Jewelry,True,2038782998822,1307.56,0.0,504534.42,Important,pranjal
609,610,17/02/2023,Jewelry,False,2720723648850,0.0,116.42,504650.84,Non-Essential,pranjal
610,611,17/02/2023,Sports,True,2275038601095,407.19,0.0,504243.65,Essential,pranjal
611,612,17/02/2023,Grocery,True,2644743345269,2456.85,0.0,501786.8,Non-Essential,pranjal
612,613,17/02/2023,Toys,False,2816490933664,0.0,459.01,502245.81,Non-important,pranjal
613,614,17/02/2023,Games,True,2150272391793,1951.34,0.0,500294.47,Non-Essential,pranjal
614,615,17/02/2023,Electronics,False,2327963944391,0.0,842.38,501136.85,Non-Essential,pranjal
615,616,17/02/2023,Electronics,False,2348398086704,0.0,2188.99,503325.84,Important,pranjal
616,617,18/02/2023,Automotive,False,2789643091032,0.0,146.81,503472.65,Essential,pranjal
617,618,18/02/2023,Automotive,False,2192837568681,0.0,1187.52,504660.17,Non-Essential,pranjal
618,619,18/02/2023,Industrial,True,2882041189959,181.01,0.0,504479.16,Essential,pranjal
619,620,18/02/2023,Baby,True,2811387806795,1134.01,0.0,503345.15,Important,pranjal
620,621,18/02/2023,Toys,False,2293593173010,0.0,2813.46,506158.61,Important,pranjal
621,622,18/02/2023,Computers,False,2806256748006,0.0,1012.32,507170.93,Essential,pranjal
622,623,18/02/2023,Electronics,False,2933625220568,0.0,1558.64,508729.57,Essential,pranjal
623,624,18/02/2023,Music,True,2374698191123,817.25,0.0,507912.32,Important,pranjal
624,625,18/02/2023,Shoes,True,2512615129201,1095.91,0.0,506816.41,Non-important,pranjal
625,626,18/02/2023,Books,False,2734751910089,0.0,1981.38,508797.79,Important,pranjal
626,627,18/02/2023,Garden,True,2404226359059,1927.45,0.0,506870.34,Essential,pranjal
627,628,18/02/2023,Outdoors,False,2256070568329,0.0,2619.5,509489.84,Non-important,pranjal
628,629,18/02/2023,Clothing,False,2049160341047,0.0,1745.65,511235.49,Essential,pranjal
629,630,18/02/2023,Games,False,2982173165186,0.0,1891.89,513127.38,Essential,pranjal
630,631,18/02/2023,Jewelry,False,2083367192427,0.0,1254.58,514381.96,Important,pranjal
631,632,18/02/2023,Computers,False,2792404064926,0.0,2048.67,516430.63,Non-important,pranjal
632,633,18/02/2023,Movies,True,2813748390092,2550.32,0.0,513880.31,Important,pranjal
633,634,19/02/2023,Grocery,False,2660886788935,0.0,2178.99,516059.3,Non-important,pranjal
634,635,19/02/2023,Electronics,True,2609304729389,822.26,0.0,515237.04,Non-important,pranjal
635,636,19/02/2023,Movies,True,2189321094092,471.39,0.0,514765.65,Non-important,pranjal
636,637,19/02/2023,Home,False,2197436606406,0.0,873.59,515639.24,Non-Essential,pranjal
637,638,19/02/2023,Home,True,2967309689514,828.98,0.0,514810.26,Essential,pranjal
638,639,19/02/2023,Home,True,2445787672778,783.59,0.0,514026.67,Important,pranjal
639,640,19/02/2023,Computers,False,2510852863767,0.0,1907.94,515934.61,Non-Essential,pranjal
640,641,19/02/2023,Garden,False,2438601137797,0.0,1847.92,517782.53,Important,pranjal
641,642,20/02/2023,Outdoors,False,2724688123242,0.0,2559.38,520341.91,Non-Essential,pranjal
642,643,20/02/2023,Toys,True,2097513957868,2454.89,0.0,517887.02,Non-important,pranjal
643,644,20/02/2023,Baby,True,2557552034677,1479.05,0.0,516407.97,Essential,pranjal
644,645,20/02/2023,Outdoors,True,2375836322790,1988.15,0.0,514419.82,Essential,pranjal
645,646,20/02/2023,Games,True,2569827154126,1461.47,0.0,512958.35,Essential,pranjal
646,647,20/02/2023,Baby,True,2697093238973,458.96,0.0,512499.39,Essential,pranjal
647,648,20/02/2023,Games,False,2466200861543,0.0,2757.54,515256.93,Non-important,pranjal
648,649,20/02/2023,Beauty,False,2908277049206,0.0,2789.91,518046.84,Non-important,pranjal
649,650,20/02/2023,Home,False,2884177189708,0.0,625.73,518672.57,Important,pranjal
650,651,20/02/2023,Books,False,2524643963585,0.0,859.48,519532.05,Important,pranjal
651,652,20/02/2023,Computers,True,2414552774683,762.74,0.0,518769.31,Essential,pranjal
652,653,20/02/2023,Beauty,False,2126939166570,0.0,2571.42,521340.73,Essential,pranjal
653,654,20/02/2023,Baby,False,2729371852845,0.0,1577.99,522918.72,Important,pranjal
654,655,21/02/2023,Jewelry,True,2105170775153,2839.28,0.0,520079.44,Essential,pranjal
655,656,21/02/2023,Garden,True,2957506688456,1156.57,0.0,518922.87,Non-Essential,pranjal
656,657,21/02/2023,Health,True,2050336093191,2010.36,0.0,516912.51,Non-Essential,pranjal
657,658,21/02/2023,Home,False,2601673084389,0.0,2718.06,519630.57,Essential,pranjal
658,659,21/02/2023,Grocery,True,2792646068821,1209.4,0.0,518421.17,Non-Essential,pranjal
659,660,21/02/2023,Music,False,2045493307712,0.0,477.14,518898.31,Important,pranjal
660,661,21/02/2023,Industrial,False,2590608350820,0.0,2139.25,521037.56,Non-important,pranjal
661,662,21/02/2023,Outdoors,False,2798883505016,0.0,2495.26,523532.82,Non-Essential,pranjal
662,663,21/02/2023,Industrial,False,2154756324536,0.0,716.36,524249.18,Non-important,pranjal
663,664,21/02/2023,Grocery,False,2138859559744,0.0,1284.56,525533.74,Non-important,pranjal
664,665,21/02/2023,Health,False,2153402440964,0.0,538.26,526072.0,Non-important,pranjal
665,666,21/02/2023,Electronics,False,2454594727167,0.0,1610.34,527682.34,Essential,pranjal
666,667,21/02/2023,Computers,True,2229446277496,822.5,0.0,526859.84,Important,pranjal
667,668,22/02/2023,Garden,True,2945873595753,1307.92,0.0,525551.92,Essential,pranjal
668,669,22/02/2023,Automotive,False,2850487948061,0.0,169.08,525721.0,Non-Essential,pranjal
669,670,22/02/2023,Automotive,False,2585866872024,0.0,1336.78,527057.78,Essential,pranjal
670,671,22/02/2023,Electronics,True,2751967885395,2609.32,0.0,524448.46,Important,pranjal
671,672,22/02/2023,Games,False,2054922841829,0.0,1618.12,526066.58,Non-important,pranjal
672,673,22/02/2023,Grocery,True,2186664629861,2467.7,0.0,523598.88,Important,pranjal
673,674,22/02/2023,Shoes,False,2495594746822,0.0,2748.02,526346.9,Important,pranjal
674,675,22/02/2023,Tools,False,2791766037627,0.0,1620.79,527967.69,Non-important,pranjal
675,676,22/02/2023,Toys,True,2635045886706,1690.65,0.0,526277.04,Non-Essential,pranjal
676,677,22/02/2023,Shoes,False,2274943297741,0.0,2630.34,528907.38,Important,pranjal
677,678,22/02/2023,Outdoors,True,2045834912060,1257.84,0.0,527649.54,Important,pranjal
678,679,22/02/2023,Games,True,2991907504487,2220.16,0.0,525429.38,Important,pranjal
679,680,23/02/2023,Grocery,False,2994432162215,0.0,371.86,525801.24,Non-important,pranjal
680,681,23/02/2023,Electronics,True,2951736734171,1616.85,0.0,524184.39,Essential,pranjal
681,682,23/02/2023,Home,True,2736496112570,2844.41,0.0,521339.98,Essential,pranjal
682,683,23/02/2023,Electronics,True,2745493613880,740.85,0.0,520599.13,Important,pranjal
683,684,23/02/2023,Shoes,True,2493425582372,775.19,0.0,519823.94,Essential,pranjal
684,685,23/02/2023,Music,False,2615968667314,0.0,1256.01,521079.95,Essential,pranjal
685,686,23/02/2023,Sports,True,2847355177959,2628.49,0.0,518451.46,Non-important,pranjal
686,687,23/02/2023,Outdoors,False,2976332421443,0.0,495.93,518947.39,Non-Essential,pranjal
687,688,23/02/2023,Toys,False,2426417120261,0.0,479.89,519427.28,Important,pranjal
688,689,24/02/2023,Grocery,False,2624236547430,0.0,1632.57,521059.85,Essential,pranjal
689,690,24/02/2023,Automotive,False,2815770859906,0.0,1519.55,522579.4,Non-Essential,pranjal
690,691,24/02/2023,Beauty,False,2157586069763,0.0,1688.76,524268.16,Non-Essential,pranjal
691,692,24/02/2023,Sports,False,2341538973478,0.0,1208.98,525477.14,Non-Essential,pranjal
692,693,24/02/2023,Health,False,2198111934622,0.0,837.04,526314.18,Essential,pranjal
693,694,24/02/2023,Electronics,False,2710121439823,0.0,925.01,527239.19,Important,pranjal
694,695,24/02/2023,Games,False,2611292191387,0.0,682.18,527921.37,Essential,pranjal
695,696,24/02/2023,Outdoors,True,2842690109202,2591.25,0.0,525330.12,Essential,pranjal
696,697,24/02/2023,Movies,False,2461217763520,0.0,2239.98,527570.1,Essential,pranjal
697,698,24/02/2023,Sports,False,2865710971898,0.0,2680.69,530250.79,Non-Essential,pranjal
698,699,24/02/2023,Music,True,2071799996539,1799.85,0.0,528450.94,Essential,pranjal
699,700,25/02/2023,Sports,True,2742537820558,1522.16,0.0,526928.78,Non-Essential,pranjal
700,701,25/02/2023,Garden,True,2497890946122,1623.07,0.0,525305.71,Essential,pranjal
701,702,25/02/2023,Music,False,2459386312825,0.0,2246.14,527551.85,Non-Essential,pranjal
702,703,25/02/2023,Games,False,2356442192971,0.0,20.23,527572.08,Essential,pranjal
703,704,25/02/2023,Games,True,2222197478103,353.31,0.0,527218.77,Essential,pranjal
704,705,25/02/2023,Jewelry,True,2663303779019,530.07,0.0,526688.7,Non-Essential,pranjal
705,706,25/02/2023,Toys,True,2020575092417,2882.17,0.0,523806.53,Non-important,pranjal
706,707,25/02/2023,Health,False,2053355851304,0.0,2344.22,526150.75,Non-Essential,pranjal
707,708,25/02/2023,Clothing,True,2920229578780,650.57,0.0,525500.18,Important,pranjal
708,709,25/02/2023,Automotive,False,2839465875472,0.0,2444.01,527944.19,Non-Essential,pranjal
709,710,25/02/2023,Electronics,True,2652091533873,1204.11,0.0,526740.08,Non-important,pranjal
710,711,25/02/2023,Outdoors,False,2175361604452,0.0,2227.71,528967.79,Non-important,pranjal
711,712,25/02/2023,Baby,True,2428011148939,1921.89,0.0,527045.9,Essential,pranjal
712,713,25/02/2023,Industrial,False,2794784217045,0.0,1488.36,528534.26,Non-Essential,pranjal
713,714,25/02/2023,Tools,False,2419408574357,0.0,2696.19,531230.45,Non-Essential,pranjal
714,715,25/02/2023,Sports,True,2026148402063,1047.82,0.0,530182.63,Essential,pranjal
715,716,25/02/2023,Games,False,2634202870494,0.0,103.91,530286.54,Non-Essential,pranjal
716,717,26/02/2023,Baby,False,2212936301908,0.0,580.53,530867.07,Non-important,pranjal
717,718,26/02/2023,Movies,False,2180632032943,0.0,326.74,531193.81,Essential,pranjal
718,719,26/02/2023,Garden,True,2180705334024,1587.62,0.0,529606.19,Non-important,pranjal
719,720,26/02/2023,Outdoors,False,2269055895959,0.0,475.83,530082.02,Non-important,pranjal
720,721,26/02/2023,Shoes,True,2176384554755,421.67,0.0,529660.35,Essential,pranjal
721,722,26/02/2023,Outdoors,True,2094945410566,43.74,0.0,529616.61,Non-Essential,pranjal
722,723,26/02/2023,Kids,False,2876524929528,0.0,2972.54,532589.15,Non-Essential,pranjal
723,724,26/02/2023,Automotive,True,2622205544933,659.09,0.0,531930.06,Non-Essential,pranjal
724,725,26/02/2023,Outdoors,False,2104211875064,0.0,2416.13,534346.19,Essential,pranjal
725,726,26/02/2023,Sports,False,2877093123964,0.0,2270.74,536616.93,Non-important,pranjal
726,727,26/02/2023,Toys,True,2301423123973,297.17,0.0,536319.76,Non-Essential,pranjal
727,728,26/02/2023,Health,True,2965462057909,2128.17,0.0,534191.59,Important,pranjal
728,729,26/02/2023,Games,True,2401876163280,2037.89,0.0,532153.7,Non-important,pranjal
729,730,27/02/2023,Home,True,2632534601691,2215.56,0.0,529938.14,Non-Essential,pranjal
730,731,27/02/2023,Books,True,2029197954680,1707.73,0.0,528230.41,Essential,pranjal
731,732,27/02/2023,Electronics,True,2993411526654,999.49,0.0,527230.92,Essential,pranjal
732,733,27/02/2023,Health,True,2272305311888,1186.49,0.0,526044.43,Non-Essential,pranjal
733,734,27/02/2023,Jewelry,True,2808028044378,1747.09,0.0,524297.34,Non-Essential,pranjal
734,735,27/02/2023,Books,False,2974570694079,0.0,2535.96,526833.3,Important,pranjal
735,736,27/02/2023,Automotive,False,2474501477831,0.0,532.03,527365.33,Non-important,pranjal
736,737,27/02/2023,Kids,False,2373377985388,0.0,964.28,528329.61,Important,pranjal
737,738,28/02/2023,Home,True,2700429367684,1218.24,0.0,527111.37,Essential,pranjal
738,739,28/02/2023,Garden,True,2402620187299,27.5,0.0,527083.87,Non-important,pranjal
739,740,28/02/2023,Movies,True,2742341360235,679.87,0.0,526404.0,Essential,pranjal
740,741,28/02/2023,Outdoors,True,2987500229567,466.65,0.0,525937.35,Essential,pranjal
741,742,28/02/2023,Sports,True,2496937711387,1079.97,0.0,524857.38,Important,pranjal
742,743,28/02/2023,Clothing,False,2791409641433,0.0,593.48,525450.86,Important,pranjal
743,744,28/02/2023,Outdoors,True,2812874242405,1837.98,0.0,523612.88,Non-Essential,pranjal
744,745,28/02/2023,Movies,False,2398601817486,0.0,1236.58,524849.46,Non-Essential,pranjal
745,746,28/02/2023,Tools,True,2424803194258,417.46,0.0,524432.0,Important,pranjal
746,747,28/02/2023,Baby,False,2538175066783,0.0,1510.11,525942.11,Important,pranjal
747,748,28/02/2023,Automotive,True,2784613113838,2540.75,0.0,523401.36,Essential,pranjal
748,749,28/02/2023,Clothing,True,2350655377850,2709.64,0.0,520691.72,Non-Essential,pranjal
749,750,28/02/2023,Beauty,True,2632236800388,2916.99,0.0,517774.73,Essential,pranjal
750,751,28/02/2023,Movies,False,2770122963414,0.0,2826.92,520601.65,Non-important,pranjal
751,752,28/02/2023,Garden,False,2023519872294,0.0,684.95,521286.6,Essential,pranjal
752,753,01/03/2023,Sports,False,2946105965280,0.0,935.53,522222.13,Non-important,pranjal
753,754,01/03/2023,Garden,True,2317571652916,2573.07,0.0,519649.06,Non-important,pranjal
754,755,01/03/2023,Movies,True,2131904371485,2414.26,0.0,517234.8,Important,pranjal
755,756,01/03/2023,Garden,True,2612198574858,1766.26,0.0,515468.54,Important,pranjal
756,757,01/03/2023,Beauty,True,2114753486611,480.37,0.0,514988.17,Non-Essential,pranjal
757,758,01/03/2023,Games,True,2239696901056,991.08,0.0,513997.09,Important,pranjal
758,759,01/03/2023,Toys,False,2818955199419,0.0,888.25,514885.34,Essential,pranjal
759,760,01/03/2023,Clothing,True,2402551323134,2700.21,0.0,512185.13,Non-Essential,pranjal
760,761,01/03/2023,Beauty,False,2296398458875,0.0,434.63,512619.76,Important,pranjal
761,762,01/03/2023,Automotive,True,2416285096779,1098.22,0.0,511521.54,Important,pranjal
762,763,01/03/2023,Grocery,True,2532563579838,540.01,0.0,510981.53,Essential,pranjal
763,764,01/03/2023,Automotive,False,2860448877710,0.0,2869.93,513851.46,Non-important,pranjal
764,765,02/03/2023,Industrial,True,2646545018496,1820.78,0.0,512030.68,Non-Essential,pranjal
765,766,02/03/2023,Toys,True,2068455607618,2588.88,0.0,509441.8,Non-important,pranjal
766,767,02/03/2023,Computers,True,2759204214144,229.21,0.0,509212.59,Non-Essential,pranjal
767,768,02/03/2023,Tools,True,2345819811453,1877.47,0.0,507335.12,Essential,pranjal
768,769,02/03/2023,Grocery,False,2852252249662,0.0,1806.4,509141.52,Non-Essential,pranjal
769,770,02/03/2023,Shoes,False,2213457119223,0.0,2320.55,511462.07,Non-Essential,pranjal
770,771,02/03/2023,Clothing,True,2940515109967,338.37,0.0,511123.7,Non-important,pranjal
771,772,02/03/2023,Tools,False,2802882416774,0.0,417.84,511541.54,Essential,pranjal
772,773,02/03/2023,Books,False,2263490528996,0.0,1157.37,512698.91,Non-Essential,pranjal
773,774,02/03/2023,Sports,True,2438481943569,2946.88,0.0,509752.03,Important,pranjal
774,775,02/03/2023,Kids,False,2458748434423,0.0,1419.1,511171.13,Non-important,pranjal
775,776,02/03/2023,Toys,True,2873363628421,950.93,0.0,510220.2,Important,pranjal
776,777,02/03/2023,Movies,True,2083428854778,1791.42,0.0,508428.78,Essential,pranjal
777,778,02/03/2023,Shoes,True,2780247611592,154.97,0.0,508273.81,Important,pranjal
778,779,02/03/2023,Jewelry,False,2148766406502,0.0,1721.8,509995.61,Non-Essential,pranjal
779,780,03/03/2023,Kids,True,2755516849793,2200.8,0.0,507794.81,Important,pranjal
780,781,03/03/2023,Home,False,2138606404724,0.0,1838.46,509633.27,Non-Essential,pranjal
781,782,03/03/2023,Music,True,2673350512119,2398.16,0.0,507235.11,Essential,pranjal
782,783,03/03/2023,Tools,False,2591639748101,0.0,2432.88,509667.99,Non-Essential,pranjal
783,784,03/03/2023,Electronics,False,2823516621664,0.0,2030.88,511698.87,Non-important,pranjal
784,785,03/03/2023,Automotive,False,2690715473361,0.0,1702.56,513401.43,Important,pranjal
785,786,03/03/2023,Health,True,2614883004815,2809.86,0.0,510591.57,Important,pranjal
786,787,03/03/2023,Tools,True,2231028127047,406.03,0.0,510185.54,Essential,pranjal
787,788,03/03/2023,Games,False,2293039724444,0.0,2890.84,513076.38,Important,pranjal
788,789,03/03/2023,Tools,True,2011058159716,580.18,0.0,512496.2,Essential,pranjal
789,790,03/03/2023,Toys,False,2772255639181,0.0,2337.94,514834.14,Important,pranjal
790,791,03/03/2023,Health,True,2909206294051,512.87,0.0,514321.27,Important,pranjal
791,792,04/03/2023,Toys,False,2902016476392,0.0,2605.46,516926.73,Non-important,pranjal
792,793,04/03/2023,Outdoors,True,2668625885714,36.17,0.0,516890.56,Essential,pranjal
793,794,04/03/2023,Tools,True,2509688832251,1885.03,0.0,515005.53,Non-Essential,pranjal
794,795,04/03/2023,Jewelry,False,2168853492639,0.0,2672.65,517678.18,Non-Essential,pranjal
795,796,04/03/2023,Kids,True,2250326734013,2685.96,0.0,514992.22,Non-important,pranjal
796,797,04/03/2023,Beauty,True,2380928415171,1385.78,0.0,513606.44,Essential,pranjal
797,798,04/03/2023,Industrial,False,2136893791719,0.0,245.31,513851.75,Essential,pranjal
798,799,04/03/2023,Home,True,2991651068093,1113.97,0.0,512737.78,Non-important,pranjal
799,800,04/03/2023,Garden,True,2044763197900,1783.28,0.0,510954.5,Non-Essential,pranjal
800,801,04/03/2023,Clothing,True,2283221699102,2472.23,0.0,508482.27,Non-Essential,pranjal
801,802,04/03/2023,Home,False,2206954040887,0.0,2865.82,511348.09,Non-important,pranjal
802,803,04/03/2023,Toys,False,2575196062896,0.0,1169.06,512517.15,Non-Essential,pranjal
803,804,04/03/2023,Computers,True,2079287899947,2766.42,0.0,509750.73,Non-Essential,pranjal
804,805,04/03/2023,Sports,False,2189051063339,0.0,2095.27,511846.0,Non-important,pranjal
805,806,05/03/2023,Clothing,False,2503493435477,0.0,1925.8,513771.8,Non-important,pranjal
806,807,05/03/2023,Industrial,False,2146173591482,0.0,1043.44,514815.24,Non-Essential,pranjal
807,808,05/03/2023,Toys,False,2863674576971,0.0,1984.36,516799.6,Non-Essential,pranjal
808,809,05/03/2023,Games,False,2192555818653,0.0,1584.8,518384.4,Essential,pranjal
809,810,05/03/2023,Electronics,True,2024310906360,417.88,0.0,517966.52,Essential,pranjal
810,811,05/03/2023,Clothing,False,2532788513289,0.0,430.74,518397.26,Non-Essential,pranjal
811,812,05/03/2023,Baby,True,2249442528090,142.46,0.0,518254.8,Essential,pranjal
812,813,05/03/2023,Kids,True,2076343630084,61.93,0.0,518192.87,Non-Essential,pranjal
813,814,05/03/2023,Games,True,2687059601989,911.05,0.0,517281.82,Important,pranjal
814,815,05/03/2023,Kids,True,2109376470831,996.36,0.0,516285.46,Non-important,pranjal
815,816,05/03/2023,Computers,False,2454208317059,0.0,1435.64,517721.1,Important,pranjal
816,817,06/03/2023,Tools,False,2127846947270,0.0,216.94,517938.04,Important,pranjal
817,818,06/03/2023,Kids,True,2934564877885,2241.41,0.0,515696.63,Non-Essential,pranjal
818,819,06/03/2023,Tools,False,2803064500709,0.0,2933.36,518629.99,Essential,pranjal
819,820,06/03/2023,Music,False,2556241450740,0.0,1546.04,520176.03,Essential,pranjal
820,821,06/03/2023,Outdoors,True,2127629742942,831.05,0.0,519344.98,Essential,pranjal
821,822,06/03/2023,Computers,True,2155273169738,757.66,0.0,518587.32,Essential,pranjal
822,823,06/03/2023,Clothing,False,2610509374779,0.0,2198.79,520786.11,Important,pranjal
823,824,06/03/2023,Outdoors,True,2248895384048,1874.93,0.0,518911.18,Non-important,pranjal
824,825,06/03/2023,Jewelry,True,2281044698194,1612.18,0.0,517299.0,Essential,pranjal
825,826,06/03/2023,Computers,True,2075932089065,1247.37,0.0,516051.63,Important,pranjal
826,827,06/03/2023,Jewelry,True,2233162327174,535.41,0.0,515516.22,Essential,pranjal
827,828,07/03/2023,Kids,True,2222116738634,1190.2,0.0,514326.02,Important,pranjal
828,829,07/03/2023,Health,False,2405056928505,0.0,1252.18,515578.2,Non-Essential,pranjal
829,830,07/03/2023,Industrial,True,2507628095551,69.79,0.0,515508.41,Essential,pranjal
830,831,07/03/2023,Health,False,2966380520501,0.0,1172.15,516680.56,Non-important,pranjal
831,832,07/03/2023,Books,False,2051051813872,0.0,2227.14,518907.7,Essential,pranjal
832,833,07/03/2023,Jewelry,True,2305932260521,2791.11,0.0,516116.59,Essential,pranjal
833,834,07/03/2023,Tools,True,2476924716749,1954.33,0.0,514162.26,Important,pranjal
834,835,07/03/2023,Outdoors,False,2397225287246,0.0,1355.17,515517.43,Essential,pranjal
835,836,08/03/2023,Baby,False,2279123846695,0.0,2555.16,518072.59,Non-Essential,pranjal
836,837,08/03/2023,Automotive,True,2224930383768,1624.3,0.0,516448.29,Non-Essential,pranjal
837,838,08/03/2023,Home,True,2548570819877,2408.51,0.0,514039.78,Important,pranjal
838,839,08/03/2023,Health,False,2493088527749,0.0,1173.24,515213.02,Essential,pranjal
839,840,08/03/2023,Automotive,False,2083123955175,0.0,1424.26,516637.28,Non-Essential,pranjal
840,841,08/03/2023,Games,False,2973831078472,0.0,2404.11,519041.39,Important,pranjal
841,842,08/03/2023,Kids,False,2545099548993,0.0,446.12,519487.51,Essential,pranjal
842,843,08/03/2023,Computers,False,2500596388182,0.0,503.58,519991.09,Non-important,pranjal
843,844,08/03/2023,Garden,True,2248615615706,403.09,0.0,519588.0,Important,pranjal
844,845,08/03/2023,Shoes,False,2430730583476,0.0,2745.17,522333.17,Non-Essential,pranjal
845,846,08/03/2023,Beauty,False,2075783490355,0.0,934.72,523267.89,Non-important,pranjal
846,847,08/03/2023,Books,False,2254295163819,0.0,564.44,523832.33,Important,pranjal
847,848,09/03/2023,Automotive,True,2042124049788,1547.89,0.0,522284.44,Important,pranjal
848,849,09/03/2023,Sports,False,2979588380926,0.0,2737.79,525022.23,Important,pranjal
849,850,09/03/2023,Grocery,True,2047973637579,502.21,0.0,524520.02,Non-important,pranjal
850,851,09/03/2023,Tools,True,2680611509277,774.97,0.0,523745.05,Important,pranjal
851,852,09/03/2023,Outdoors,True,2801953251696,1372.53,0.0,522372.52,Non-Essential,pranjal
852,853,09/03/2023,Jewelry,True,2781107723223,442.41,0.0,521930.11,Non-important,pranjal
853,854,09/03/2023,Garden,False,2757376677230,0.0,2035.8,523965.91,Essential,pranjal
854,855,09/03/2023,Games,False,2034124531325,0.0,113.01,524078.92,Essential,pranjal
855,856,09/03/2023,Electronics,False,2835643576190,0.0,1705.63,525784.55,Essential,pranjal
856,857,10/03/2023,Health,True,2256455177549,1402.19,0.0,524382.36,Non-important,pranjal
857,858,10/03/2023,Clothing,True,2426554913149,2263.47,0.0,522118.89,Non-Essential,pranjal
858,859,10/03/2023,Home,False,2650894471492,0.0,2692.96,524811.85,Non-Essential,pranjal
859,860,10/03/2023,Computers,True,2547476555884,1496.69,0.0,523315.16,Non-important,pranjal
860,861,10/03/2023,Clothing,False,2876561809050,0.0,1856.4,525171.56,Essential,pranjal
861,862,10/03/2023,Movies,False,2891969812595,0.0,2516.24,527687.8,Important,pranjal
862,863,10/03/2023,Shoes,True,2137006008042,1308.41,0.0,526379.39,Non-Essential,pranjal
863,864,11/03/2023,Books,False,2674471361044,0.0,584.33,526963.72,Important,pranjal
864,865,11/03/2023,Kids,True,2482557553895,1344.58,0.0,525619.14,Non-important,pranjal
865,866,11/03/2023,Outdoors,False,2210867940077,0.0,2127.48,527746.62,Important,pranjal
866,867,11/03/2023,Toys,True,2128489927557,1730.66,0.0,526015.96,Non-important,pranjal
867,868,11/03/2023,Computers,True,2989849377059,2697.13,0.0,523318.83,Non-important,pranjal
868,869,11/03/2023,Baby,False,2039369420531,0.0,83.86,523402.69,Non-important,pranjal
869,870,11/03/2023,Games,True,2179691929834,168.38,0.0,523234.31,Essential,pranjal
870,871,11/03/2023,Computers,False,2512419694274,0.0,1414.47,524648.78,Essential,pranjal
871,872,11/03/2023,Baby,True,2324265576548,153.23,0.0,524495.55,Non-Essential,pranjal
872,873,11/03/2023,Electronics,False,2280335885122,0.0,794.27,525289.82,Important,pranjal
873,874,12/03/2023,Computers,True,2592626355972,2852.56,0.0,522437.26,Non-important,pranjal
874,875,12/03/2023,Outdoors,False,2159092392374,0.0,2157.22,524594.48,Non-Essential,pranjal
875,876,12/03/2023,Music,False,2979052263224,0.0,1333.57,525928.05,Non-Essential,pranjal
876,877,12/03/2023,Jewelry,True,2474641490789,1677.81,0.0,524250.24,Non-Essential,pranjal
877,878,12/03/2023,Outdoors,False,2451158718160,0.0,1463.54,525713.78,Non-important,pranjal
878,879,12/03/2023,Shoes,False,2820086804353,0.0,2404.1,528117.88,Non-important,pranjal
879,880,12/03/2023,Music,True,2959524881117,485.23,0.0,527632.65,Non-Essential,pranjal
880,881,12/03/2023,Shoes,True,2139104553287,763.23,0.0,526869.42,Non-Essential,pranjal
881,882,12/03/2023,Garden,False,2348284810308,0.0,1894.09,528763.51,Non-important,pranjal
882,883,12/03/2023,Kids,True,2297464019355,2137.14,0.0,526626.37,Essential,pranjal
883,884,12/03/2023,Kids,True,2972175152039,2190.05,0.0,524436.32,Non-Essential,pranjal
884,885,12/03/2023,Beauty,True,2622652854041,1806.63,0.0,522629.69,Non-Essential,pranjal
885,886,12/03/2023,Kids,True,2646298634519,90.33,0.0,522539.36,Non-important,pranjal
886,887,12/03/2023,Industrial,False,2607751496482,0.0,513.47,523052.83,Non-important,pranjal
887,888,12/03/2023,Tools,True,2782059405294,102.44,0.0,522950.39,Essential,pranjal
888,889,12/03/2023,Shoes,True,2362568404640,2997.9,0.0,519952.49,Important,pranjal
889,890,12/03/2023,Sports,True,2206175219093,2744.61,0.0,517207.88,Non-Essential,pranjal
890,891,12/03/2023,Computers,False,2916281099891,0.0,1931.54,519139.42,Non-important,pranjal
891,892,12/03/2023,Music,True,2773630453020,2493.65,0.0,516645.77,Essential,pranjal
892,893,12/03/2023,Industrial,False,2239299687041,0.0,1396.32,518042.09,Important,pranjal
893,894,12/03/2023,Games,True,2043511466058,1089.36,0.0,516952.73,Non-important,pranjal
894,895,13/03/2023,Kids,False,2101918159611,0.0,2745.82,519698.55,Non-Essential,pranjal
895,896,13/03/2023,Toys,False,2347005750626,0.0,2277.41,521975.96,Important,pranjal
896,897,13/03/2023,Industrial,True,2452448033285,140.06,0.0,521835.9,Important,pranjal
897,898,13/03/2023,Shoes,True,2524537234039,2580.01,0.0,519255.89,Essential,pranjal
898,899,13/03/2023,Movies,True,2795634618597,964.65,0.0,518291.24,Important,pranjal
899,900,13/03/2023,Games,False,2455913877735,0.0,692.82,518984.06,Non-Essential,pranjal
900,901,13/03/2023,Outdoors,True,2805389710244,30.83,0.0,518953.23,Non-Essential,pranjal
901,902,13/03/2023,Garden,True,2179911284192,447.94,0.0,518505.29,Essential,pranjal
902,903,13/03/2023,Books,True,2374956199244,1193.85,0.0,517311.44,Non-Essential,pranjal
903,904,14/03/2023,Outdoors,False,2621424945312,0.0,16.4,517327.84,Important,pranjal
904,905,14/03/2023,Jewelry,False,2306074582562,0.0,1540.07,518867.91,Non-Essential,pranjal
905,906,14/03/2023,Movies,True,2090104266876,2141.51,0.0,516726.4,Non-Essential,pranjal
906,907,14/03/2023,Music,True,2314378693501,1048.32,0.0,515678.08,Essential,pranjal
907,908,14/03/2023,Health,False,2662209863151,0.0,2425.54,518103.62,Non-Essential,pranjal
908,909,14/03/2023,Toys,True,2440239379976,2592.69,0.0,515510.93,Important,pranjal
909,910,14/03/2023,Sports,False,2033535774211,0.0,2030.64,517541.57,Non-important,pranjal
910,911,14/03/2023,Industrial,True,2805038260685,662.64,0.0,516878.93,Non-Essential,pranjal
911,912,14/03/2023,Movies,False,2582181921590,0.0,99.35,516978.28,Essential,pranjal
912,913,15/03/2023,Electronics,True,2758415473708,886.06,0.0,516092.22,Essential,pranjal
913,914,15/03/2023,Jewelry,True,2448571982873,1419.12,0.0,514673.1,Non-important,pranjal
914,915,15/03/2023,Home,True,2876844807045,2180.43,0.0,512492.67,Important,pranjal
915,916,15/03/2023,Industrial,True,2755464308919,537.99,0.0,511954.68,Non-Essential,pranjal
916,917,15/03/2023,Music,True,2554260985016,1138.84,0.0,510815.84,Non-important,pranjal
917,918,15/03/2023,Toys,True,2273649240008,1019.74,0.0,509796.1,Non-Essential,pranjal
918,919,15/03/2023,Health,False,2852481069383,0.0,1996.59,511792.69,Non-important,pranjal
919,920,15/03/2023,Sports,True,2573317214417,110.06,0.0,511682.63,Non-important,pranjal
920,921,15/03/2023,Baby,False,2058594101298,0.0,2693.37,514376.0,Non-Essential,pranjal
921,922,15/03/2023,Health,False,2500921440034,0.0,2938.59,517314.59,Essential,pranjal
922,923,16/03/2023,Movies,False,2139791049602,0.0,2386.5,519701.09,Important,pranjal
923,924,16/03/2023,Outdoors,False,2579663254185,0.0,439.69,520140.78,Non-important,pranjal
924,925,16/03/2023,Books,False,2362637418611,0.0,1146.76,521287.54,Important,pranjal
925,926,17/03/2023,Shoes,False,2251858364140,0.0,964.97,522252.51,Non-important,pranjal
926,927,17/03/2023,Games,False,2648294748723,0.0,973.11,523225.62,Important,pranjal
927,928,17/03/2023,Movies,False,2605553590243,0.0,2281.68,525507.3,Non-important,pranjal
928,929,17/03/2023,Toys,True,2202034677315,122.13,0.0,525385.17,Non-important,pranjal
929,930,17/03/2023,Grocery,True,2936113858714,2019.01,0.0,523366.16,Non-Essential,pranjal
930,931,17/03/2023,Industrial,False,2669993350717,0.0,1567.22,524933.38,Essential,pranjal
931,932,17/03/2023,Grocery,True,2871301188840,2678.31,0.0,522255.07,Non-important,pranjal
932,933,17/03/2023,Toys,True,2323558649838,2994.14,0.0,519260.93,Non-Essential,pranjal
933,934,17/03/2023,Grocery,False,2720090177509,0.0,137.4,519398.33,Essential,pranjal
934,935,17/03/2023,Garden,True,2591561843319,1435.45,0.0,517962.88,Essential,pranjal
935,936,17/03/2023,Health,False,2489886367496,0.0,2404.97,520367.85,Non-Essential,pranjal
936,937,17/03/2023,Books,True,2773956123346,1433.24,0.0,518934.61,Non-important,pranjal
937,938,17/03/2023,Grocery,False,2915266756123,0.0,2306.37,521240.98,Non-Essential,pranjal
938,939,17/03/2023,Beauty,False,2193751647947,0.0,767.02,522008.0,Non-important,pranjal
939,940,17/03/2023,Health,True,2763076604443,1094.72,0.0,520913.28,Important,pranjal
940,941,17/03/2023,Baby,False,2907710727200,0.0,1420.21,522333.49,Essential,pranjal
941,942,18/03/2023,Movies,True,2371113880479,320.19,0.0,522013.3,Important,pranjal
942,943,18/03/2023,Baby,False,2175607008818,0.0,162.81,522176.11,Important,pranjal
943,944,18/03/2023,Sports,False,2166220544982,0.0,1588.72,523764.83,Essential,pranjal
944,945,18/03/2023,Outdoors,True,2602150663049,1883.63,0.0,521881.2,Non-important,pranjal
945,946,18/03/2023,Games,False,2049915328285,0.0,1740.49,523621.69,Essential,pranjal
946,947,18/03/2023,Jewelry,True,2742886526769,202.44,0.0,523419.25,Non-Essential,pranjal
947,948,18/03/2023,Outdoors,True,2827298335378,2009.31,0.0,521409.94,Non-important,pranjal
948,949,18/03/2023,Games,False,2793713990625,0.0,2373.03,523782.97,Important,pranjal
949,950,18/03/2023,Garden,True,2981819497420,733.41,0.0,523049.56,Essential,pranjal
950,951,18/03/2023,Automotive,True,2530192144508,998.98,0.0,522050.58,Non-important,pranjal
951,952,18/03/2023,Beauty,False,2839160740686,0.0,1380.72,523431.3,Essential,pranjal
952,953,19/03/2023,Baby,False,2401867533051,0.0,2779.41,526210.71,Essential,pranjal
953,954,19/03/2023,Electronics,True,2966016710263,2197.35,0.0,524013.36,Essential,pranjal
954,955,19/03/2023,Kids,True,2620759335389,862.26,0.0,523151.1,Important,pranjal
955,956,19/03/2023,Baby,True,2063745727446,182.15,0.0,522968.95,Non-Essential,pranjal
956,957,19/03/2023,Jewelry,True,2618008048584,2235.0,0.0,520733.95,Non-Essential,pranjal
957,958,19/03/2023,Music,True,2207343027093,2802.55,0.0,517931.4,Important,pranjal
958,959,19/03/2023,Outdoors,False,2044071019113,0.0,1.01,517932.41,Essential,pranjal
959,960,19/03/2023,Shoes,True,2843309806254,2270.24,0.0,515662.17,Non-Essential,pranjal
960,961,19/03/2023,Shoes,False,2749684932067,0.0,1370.36,517032.53,Non-Essential,pranjal
961,962,19/03/2023,Electronics,True,2363186191274,2784.98,0.0,514247.55,Essential,pranjal
962,963,19/03/2023,Clothing,False,2346044091110,0.0,152.13,514399.68,Non-important,pranjal
963,964,19/03/2023,Tools,False,2917349419587,0.0,1198.18,515597.86,Important,pranjal
964,965,19/03/2023,Games,True,2467403735886,1629.22,0.0,513968.64,Non-important,pranjal
965,966,19/03/2023,Grocery,True,2211064929679,2952.85,0.0,511015.79,Non-important,pranjal
966,967,19/03/2023,Sports,True,2395101619433,2624.91,0.0,508390.88,Important,pranjal
967,968,19/03/2023,Automotive,False,2396217386940,0.0,37.79,508428.67,Non-important,pranjal
968,969,20/03/2023,Jewelry,True,2264145780505,2778.02,0.0,505650.65,Essential,pranjal
969,970,20/03/2023,Kids,True,2792490345780,2825.83,0.0,502824.82,Essential,pranjal
970,971,20/03/2023,Electronics,True,2523355562875,176.93,0.0,502647.89,Essential,pranjal
971,972,20/03/2023,Music,False,2230352030035,0.0,2307.03,504954.92,Non-important,pranjal
972,973,20/03/2023,Baby,False,2312848992317,0.0,336.9,505291.82,Non-Essential,pranjal
973,974,20/03/2023,Industrial,False,2768290704598,0.0,2244.37,507536.19,Non-important,pranjal
974,975,20/03/2023,Tools,False,2289329351204,0.0,404.63,507940.82,Important,pranjal
975,976,20/03/2023,Sports,False,2281292944304,0.0,2532.98,510473.8,Important,pranjal
976,977,20/03/2023,Grocery,True,2948657712907,1786.45,0.0,508687.35,Non-important,pranjal
977,978,20/03/2023,Books,True,2114767341144,1676.44,0.0,507010.91,Non-Essential,pranjal
978,979,20/03/2023,Garden,False,2486498642299,0.0,652.31,507663.22,Non-important,pranjal
979,980,21/03/2023,Toys,True,2006091361473,943.6,0.0,506719.62,Non-Essential,pranjal
980,981,21/03/2023,Automotive,False,2310502463566,0.0,725.04,507444.66,Essential,pranjal
981,982,21/03/2023,Health,False,2933266384588,0.0,1182.17,508626.83,Non-Essential,pranjal
982,983,21/03/2023,Industrial,True,2194453601005,2202.74,0.0,506424.09,Non-important,pranjal
983,984,21/03/2023,Shoes,True,2166934787845,315.06,0.0,506109.03,Non-important,pranjal
984,985,21/03/2023,Kids,True,2037766245160,1718.09,0.0,504390.94,Important,pranjal
985,986,21/03/2023,Toys,True,2769780725992,1727.33,0.0,502663.61,Non-important,pranjal
986,987,21/03/2023,Electronics,True,2773501997882,415.26,0.0,502248.35,Essential,pranjal
987,988,21/03/2023,Industrial,True,2434553409731,2882.73,0.0,499365.62,Non-Essential,pranjal
988,989,22/03/2023,Baby,False,2018462415284,0.0,1620.08,500985.7,Essential,pranjal
989,990,22/03/2023,Toys,False,2245575841640,0.0,894.58,501880.28,Important,pranjal
990,991,22/03/2023,Garden,False,2626774078925,0.0,1605.56,503485.84,Important,pranjal
991,992,22/03/2023,Baby,False,2544845687169,0.0,1027.49,504513.33,Non-Essential,pranjal
992,993,22/03/2023,Computers,False,2056533111205,0.0,2972.94,507486.27,Non-Essential,pranjal
993,994,22/03/2023,Computers,True,2340881957624,99.71,0.0,507386.56,Non-important,pranjal
994,995,22/03/2023,Kids,False,2792823161702,0.0,1953.46,509340.02,Non-important,pranjal
995,996,22/03/2023,Garden,True,2583339860821,530.74,0.0,508809.28,Non-Essential,pranjal
996,997,22/03/2023,Books,True,2960101898434,628.21,0.0,508181.07,Non-Essential,pranjal
997,998,22/03/2023,Books,True,2944085170994,2360.83,0.0,505820.24,Non-important,pranjal
998,999,22/03/2023,Electronics,False,2008134651678,0.0,2663.06,508483.3,Essential,pranjal
999,1000,22/03/2023,Outdoors,True,2665354316796,861.79,0.0,507621.51,Non-Essential,pranjal
